repo,sha,parent_sha,author,before_files,after_files,before_nloc,after_nloc,delta_nloc,before_ccn_sum,after_ccn_sum,delta_ccn_sum,before_ccn_mean,after_ccn_mean,delta_ccn_mean,additions,deletions,linhas_adicionadas_por_delta_ccn,path_before,path_after
zenkiotsuka-beep/chcmw-bible-qa-v3,e2967be17b16982eb07a57e828d8cca19fa3b673,84b08887a6865ba4facc7b95d6379272b762292f,zenkiotsuka-beep,5,4,96,73,-23,8,4,-4,2.667,2.0,-0.667,0,26,0.0,analises_projeto_lote/zenkiotsuka-beep_chcmw-bible-qa-v3_e2967be_1756608515/before,analises_projeto_lote/zenkiotsuka-beep_chcmw-bible-qa-v3_e2967be_1756608515/after
juniormag/SportsGPT,ac747766718563414017490ecc48b7b06f1d1953,a1f7ef6159a0c0db73902d6ac679aae0139e54f0,Junior Magalhães,106,121,11578,15288,3710,118,247,129,1.844,2.573,0.729,5025,327,38.953,analises_projeto_lote/juniormag_SportsGPT_ac74776_1756608522/before,analises_projeto_lote/juniormag_SportsGPT_ac74776_1756608522/after
zfogg/ascii-chat,87044a40cca6d442b66aeb783639dee5241a15fa,e115ffcee1aa9e23c8a606ee04d3ecc6264f76f0,zfogg,120,120,236938,235939,-999,3833,3792,-41,4.864,4.938,0.074,1430,2935,34.878,analises_projeto_lote/zfogg_ascii-chat_87044a4_1756609130/before,analises_projeto_lote/zfogg_ascii-chat_87044a4_1756609130/after
IDLEcreative/Omniops,73065a6534a3b51f97277d6095b762044d905110,fc250d72e19d8cc4aabde4035bf588dcd61751e1,james,542,544,120354,120534,180,5233,5240,7,1.736,1.736,0.0,312,7,44.571,analises_projeto_lote/IDLEcreative_Omniops_73065a6_1756609761/before,analises_projeto_lote/IDLEcreative_Omniops_73065a6_1756609761/after
gchallen/gchallen.github.io,7c2722281202d85ec283b592a4c2955b11b99640,5fe5fca6f307c676205135cc40434a92e7d54c52,gchallen,0,0,0,0,0,0,0,0,0.0,0.0,0.0,230,56,,analises_projeto_lote/gchallen_gchallen.github.io_7c27222_1756609775/before,analises_projeto_lote/gchallen_gchallen.github.io_7c27222_1756609775/after
slatedb/slatedb,1337da826524d894a95107cc718b6b9de2d8597e,4633b38c82db3395e456ad270a52b529010fb785,criccomini,231,234,59314,59348,34,3152,3152,0,2.115,2.115,0.0,39,0,,analises_projeto_lote/slatedb_slatedb_1337da8_1756609783/before,analises_projeto_lote/slatedb_slatedb_1337da8_1756609783/after
kp30evg/evg-ai,264c4914ae7513f17a75fd29eec3f714b8875a73,03411752dceb2290ccfffed8dac73650ac4c7904,kp30evg,15,24,6366,17837,11471,2,12,10,1.0,1.091,0.091,2379,144,237.9,analises_projeto_lote/kp30evg_evg-ai_264c491_1756609794/before,analises_projeto_lote/kp30evg_evg-ai_264c491_1756609794/after
owulveryck/gomcptest,b7571b95b84efa821aabbe7481cb5fad0802413a,b46b67ca7fc4c11465aa729c7f8c930ec9cbddd5,owulveryck,263,283,165325,188730,23405,2731,2954,223,2.628,2.708,0.08,2016,0,9.04,analises_projeto_lote/owulveryck_gomcptest_b7571b9_1756609805/before,analises_projeto_lote/owulveryck_gomcptest_b7571b9_1756609805/after
zfogg/ascii-chat,24bc48a5b67708de92e2a96a8174e1b714ce989e,dc5d18c8149cdc28ac5ee8bd634468ad185f788e,zfogg,110,110,237501,237511,10,3982,3979,-3,4.934,4.931,-0.003,1650,1662,550.0,analises_projeto_lote/zfogg_ascii-chat_24bc48a_1756609979/before,analises_projeto_lote/zfogg_ascii-chat_24bc48a_1756609979/after
RDG-CONSULTORES/pollo-loco-supervision,efdf7360070e09f4bca316deb3150f407115a618,dba8aeb8202d4e0be87de4f569ea33bde48a3695,Roberto Dávila,78,79,17722,17855,133,781,789,8,2.152,2.132,-0.02,199,4,24.875,analises_projeto_lote/RDG-CONSULTORES_pollo-loco-supervision_efdf736_1756610708/before,analises_projeto_lote/RDG-CONSULTORES_pollo-loco-supervision_efdf736_1756610708/after
tmoody1973/public-radio-agents,dbf999cc5e104e5a6caaba56a1f4558ffcb0c472,22834f44ea8e3885618a8fcaa362d4289816f3d8,tmoody1973,135,160,41652,83212,41560,138,339,201,2.339,2.106,-0.233,43637,225,217.1,analises_projeto_lote/tmoody1973_public-radio-agents_dbf999c_1756610715/before,analises_projeto_lote/tmoody1973_public-radio-agents_dbf999c_1756610715/after
RDG-CONSULTORES/pollo-loco-supervision,dba8aeb8202d4e0be87de4f569ea33bde48a3695,98a7990c2d525b309bdee967109bc8b30f739348,Roberto Dávila,78,78,17614,17722,108,781,781,0,2.152,2.152,0.0,156,14,,analises_projeto_lote/RDG-CONSULTORES_pollo-loco-supervision_dba8aeb_1756610735/before,analises_projeto_lote/RDG-CONSULTORES_pollo-loco-supervision_dba8aeb_1756610735/after
IDLEcreative/Omniops,85d05d1061deb907972010338d893816b92a6acb,81e4c7a22d7b8c667cb75c7530572e94bf47cf4c,james,363,374,77818,80724,2906,3609,3933,324,1.801,1.739,-0.062,4692,112,14.481,analises_projeto_lote/IDLEcreative_Omniops_85d05d1_1756610742/before,analises_projeto_lote/IDLEcreative_Omniops_85d05d1_1756610742/after
RDG-CONSULTORES/pollo-loco-supervision,98a7990c2d525b309bdee967109bc8b30f739348,90b844f85ba9cb8d61c39bb3f65c61920719f900,Roberto Dávila,76,78,17339,17614,275,775,781,6,2.165,2.152,-0.013,387,10,64.5,analises_projeto_lote/RDG-CONSULTORES_pollo-loco-supervision_98a7990_1756610754/before,analises_projeto_lote/RDG-CONSULTORES_pollo-loco-supervision_98a7990_1756610754/after
karlis-benefelds/Transcriber,d6b1603771a21cb3c3f239fad6922c2bbadefdc7,02b45339fbe8a431cf40436392a3946cf15dcd7f,Karlis Benefelds,20,28,5055,6468,1413,415,551,136,4.663,4.63,-0.033,2041,55,15.007,analises_projeto_lote/karlis-benefelds_Transcriber_d6b1603_1756610761/before,analises_projeto_lote/karlis-benefelds_Transcriber_d6b1603_1756610761/after
dailyatti/promptgy-jtem-ny3,189913a87688ea57fe7700de0bbc6bdf74ddb6e1,5b99c529143fb26d3ecb16a6a922bf72a6a84ceb,dailyatti,10,10,2830,3001,171,139,188,49,2.673,2.507,-0.166,254,33,5.184,analises_projeto_lote/dailyatti_promptgy-jtem-ny3_189913a_1756611368/before,analises_projeto_lote/dailyatti_promptgy-jtem-ny3_189913a_1756611368/after
owulveryck/gomcptest,5ed86920311c8173978d60a3ab43b68b16903c1e,2d3e7729ce9e63e9abef5eef580c660dc6bd7959,owulveryck,263,263,164437,164490,53,2607,2608,1,2.558,2.559,0.001,64,8,64.0,analises_projeto_lote/owulveryck_gomcptest_5ed8692_1756611375/before,analises_projeto_lote/owulveryck_gomcptest_5ed8692_1756611375/after
ck999kk/DOCUMENTARY,5aa0be65e4f8fc4dc7e9b66f979c5331ae91c4a6,1ba67e9d73bece470168fcedc43210b806ea2056,VCAT Evidence Custodian,464,469,1145232,1146749,1517,1,1,0,1.0,1.0,0.0,2011,0,,analises_projeto_lote/ck999kk_DOCUMENTARY_5aa0be6_1756611468/before,analises_projeto_lote/ck999kk_DOCUMENTARY_5aa0be6_1756611468/after
xlsynth/xlsynth-crate,9a107cad85f31395b3d792d5dcdae55138fd7631,d3d79c7f30a670cad691e806d883610832af1ab2,cdleary,262,262,73146,73413,267,5377,5397,20,2.799,2.801,0.002,273,0,13.65,analises_projeto_lote/xlsynth_xlsynth-crate_9a107ca_1756612025/before,analises_projeto_lote/xlsynth_xlsynth-crate_9a107ca_1756612025/after
remiangelo/harvestApp,4270ec85065307ca92178bda32c7b461f13e40f2,5a23ddec19bd6fcdba4a04fbbfd99fbbae505f26,remiangelo,231,239,55927,58178,2251,1539,1725,186,2.186,2.195,0.009,3145,105,16.909,analises_projeto_lote/remiangelo_harvestApp_4270ec8_1756612036/before,analises_projeto_lote/remiangelo_harvestApp_4270ec8_1756612036/after
RDG-CONSULTORES/pollo-loco-supervision,389afe6f48674b780ebd684c8996b38a0901dcb9,b2768b0bf4918e2b5e2a8792bf0205d09bdc071a,Roberto Dávila,73,73,16330,16360,30,699,699,0,2.198,2.198,0.0,40,5,,analises_projeto_lote/RDG-CONSULTORES_pollo-loco-supervision_389afe6_1756612247/before,analises_projeto_lote/RDG-CONSULTORES_pollo-loco-supervision_389afe6_1756612247/after
skyasu2/openmanager-vibe-v5,a363930f4299ada793784304d2346fc543ae40ba,0f65d0dae4cadbcfaea74bfb9996246a0b241e4d,skyasu2,1465,1465,476134,475916,-218,18386,18379,-7,1.772,1.772,0.0,205,554,29.286,analises_projeto_lote/skyasu2_openmanager-vibe-v5_a363930_1756612255/before,analises_projeto_lote/skyasu2_openmanager-vibe-v5_a363930_1756612255/after
riscv/meta-riscv,1cb6c4a83c53480d38e18598afa01ed99a60ace4,b23fa3ca051b5d4f91f2b90064710e4419146d66,kraj,264,264,62925,62925,0,229,229,0,1.924,1.924,0.0,2,1,,analises_projeto_lote/riscv_meta-riscv_1cb6c4a_1756612282/before,analises_projeto_lote/riscv_meta-riscv_1cb6c4a_1756612282/after
bazil852/frank,e6a1210c29b0477aeb42831c48f17dfe9dcefa27,32276910ca7d4410e4cf893ab88af4cd8d49dfce,Bazil Sajjad,32,32,7592,7592,0,109,109,0,1.847,1.847,0.0,45,8,,analises_projeto_lote/bazil852_frank_e6a1210_1756612851/before,analises_projeto_lote/bazil852_frank_e6a1210_1756612851/after
Konoa-1025/JCL-Cloud,eee713fdd2ac55ed4eaf6e30389e091287e9bf31,a96ec956ec9a8befffc172cb49a416ec96145042,Konoa-1025,22,22,3057,3078,21,154,154,0,6.417,6.417,0.0,90,59,,analises_projeto_lote/Konoa-1025_JCL-Cloud_eee713f_1756612858/before,analises_projeto_lote/Konoa-1025_JCL-Cloud_eee713f_1756612858/after
Soynido/GEO-Rush,3a7d7c132642ddc156813218507d0f1bac1bc8be,5f8dcce55a1fde661012cf1d3571dbac98d1f53c,Soynido,4,12,198,4126,3928,17,243,226,2.833,4.119,1.286,4253,1,18.819,analises_projeto_lote/Soynido_GEO-Rush_3a7d7c1_1756612866/before,analises_projeto_lote/Soynido_GEO-Rush_3a7d7c1_1756612866/after
HeapsGo0d/ignition,e1f7a8a13e0d510a23249c1fb91d8026cfead5dc,5afbff28458e5585b708da2e7e84e3ede0e3feee,HeapsGo0d,10,10,1341,1372,31,104,106,2,3.586,3.655,0.069,65,38,32.5,analises_projeto_lote/HeapsGo0d_ignition_e1f7a8a_1756612872/before,analises_projeto_lote/HeapsGo0d_ignition_e1f7a8a_1756612872/after
JihunKong/POProject,b658d2ffc36b082171c3f5c6ae28402e131f9c31,3a568b39851c47d06b956cbfc4bcca5ebfded68f,JihunKong,88,89,47479,62841,15362,608,608,0,2.937,2.937,0.0,35,23,,analises_projeto_lote/JihunKong_POProject_b658d2f_1756613479/before,analises_projeto_lote/JihunKong_POProject_b658d2f_1756613479/after
teano-uTTu-9788/ag06_mixer,73530be83b87be319710e05ac52aabf9595fde85,4aa3712bf44bb0173941ae71e3cc52012b9e02aa,teano-uTTu-9788,1247,1252,218311,220278,1967,22009,22205,196,2.774,2.778,0.004,2476,0,12.633,analises_projeto_lote/teano-uTTu-9788_ag06_mixer_73530be_1756613613/before,analises_projeto_lote/teano-uTTu-9788_ag06_mixer_73530be_1756613613/after
teano-uTTu-9788/ag06_mixer,4aa3712bf44bb0173941ae71e3cc52012b9e02aa,0c8f4486969f033a3ee76151d9ad0361642879d8,teano-uTTu-9788,1245,1247,218029,218311,282,22009,22009,0,2.774,2.774,0.0,317,0,,analises_projeto_lote/teano-uTTu-9788_ag06_mixer_4aa3712_1756613630/before,analises_projeto_lote/teano-uTTu-9788_ag06_mixer_4aa3712_1756613630/after
teano-uTTu-9788/ag06_mixer,0c8f4486969f033a3ee76151d9ad0361642879d8,b45c740f2e3f1a09bc7b66f7ff943974404fcff2,teano-uTTu-9788,1224,1245,207957,218029,10072,21074,22009,935,2.761,2.774,0.013,11871,22,12.696,analises_projeto_lote/teano-uTTu-9788_ag06_mixer_0c8f448_1756613648/before,analises_projeto_lote/teano-uTTu-9788_ag06_mixer_0c8f448_1756613648/after
teano-uTTu-9788/ag06_mixer,b45c740f2e3f1a09bc7b66f7ff943974404fcff2,1600c1780b6bfcbea3410d1bf22d4aabebe51452,teano-uTTu-9788,1224,1224,207957,207957,0,21074,21074,0,2.761,2.761,0.0,5,5,,analises_projeto_lote/teano-uTTu-9788_ag06_mixer_b45c740_1756613666/before,analises_projeto_lote/teano-uTTu-9788_ag06_mixer_b45c740_1756613666/after
mgisrael393823/OM-AI,bfcc17c0b02769be9726a7aca408364f3e989fdd,cf00e0aa3c9c04d5b3f92521eb1df466b3f84988,mgisrael393823,349,356,87418,88471,1053,3718,3838,120,1.931,1.906,-0.025,2355,1075,19.625,analises_projeto_lote/mgisrael393823_OM-AI_bfcc17c_1756613684/before,analises_projeto_lote/mgisrael393823_OM-AI_bfcc17c_1756613684/after
teano-uTTu-9788/ag06_mixer,1600c1780b6bfcbea3410d1bf22d4aabebe51452,0cd5edcda143854320efca373a3c35b22d9d21a3,teano-uTTu-9788,1222,1224,207575,207957,382,21034,21074,40,2.762,2.761,-0.001,470,2,11.75,analises_projeto_lote/teano-uTTu-9788_ag06_mixer_1600c17_1756613895/before,analises_projeto_lote/teano-uTTu-9788_ag06_mixer_1600c17_1756613895/after
teano-uTTu-9788/ag06_mixer,0cd5edcda143854320efca373a3c35b22d9d21a3,79480b2461ee66194c29c10553519df562f7308c,teano-uTTu-9788,1219,1222,207028,207575,547,21034,21034,0,2.762,2.762,0.0,583,0,,analises_projeto_lote/teano-uTTu-9788_ag06_mixer_0cd5edc_1756613913/before,analises_projeto_lote/teano-uTTu-9788_ag06_mixer_0cd5edc_1756613913/after
teano-uTTu-9788/ag06_mixer,79480b2461ee66194c29c10553519df562f7308c,c135d103bfcb96f3001f7268fa6ad146ab2cec78,teano-uTTu-9788,1219,1219,207028,207028,0,21034,21034,0,2.762,2.762,0.0,20,20,,analises_projeto_lote/teano-uTTu-9788_ag06_mixer_79480b2_1756613930/before,analises_projeto_lote/teano-uTTu-9788_ag06_mixer_79480b2_1756613930/after
teano-uTTu-9788/ag06_mixer,c135d103bfcb96f3001f7268fa6ad146ab2cec78,98b76ba147235bf2f3dadab0d66d5b14661d12a8,teano-uTTu-9788,1214,1219,205580,207028,1448,20912,21034,122,2.76,2.762,0.002,2455,0,20.123,analises_projeto_lote/teano-uTTu-9788_ag06_mixer_c135d10_1756613948/before,analises_projeto_lote/teano-uTTu-9788_ag06_mixer_c135d10_1756613948/after
teano-uTTu-9788/ag06_mixer,98b76ba147235bf2f3dadab0d66d5b14661d12a8,47e3c7715a7457725511fa9939f640c55ad1d809,teano-uTTu-9788,1214,1214,205580,205580,0,20912,20912,0,2.76,2.76,0.0,20,20,,analises_projeto_lote/teano-uTTu-9788_ag06_mixer_98b76ba_1756613965/before,analises_projeto_lote/teano-uTTu-9788_ag06_mixer_98b76ba_1756613965/after
voyd-lang/voyd,e55b6280fabdcd0d18493931acc9fea7a1f32d1f,04c589b6c4e2ba70ff1fbe1aecfb9c64a701e384,drew-y,308,310,24216,24296,80,2371,2384,13,1.999,2.0,0.001,93,5,7.154,analises_projeto_lote/voyd-lang_voyd_e55b628_1756613982/before,analises_projeto_lote/voyd-lang_voyd_e55b628_1756613982/after
xlsynth/xlsynth-crate,c1cc53a80db85403611ea846d4457028871ff21b,96e1826f123a70976ee27bcd90b4c52e77fa2191,cdleary,261,261,73006,73055,49,5372,5372,0,2.801,2.801,0.0,60,0,,analises_projeto_lote/xlsynth_xlsynth-crate_c1cc53a_1756613991/before,analises_projeto_lote/xlsynth_xlsynth-crate_c1cc53a_1756613991/after
adamyap78/ai-kanban,8409a7ed966fed6c347e9db05cfc1d2b643f1901,8dfa452716cdccc127ff28f5b6965b72f3fd73fc,adamyap78,43,43,11413,11573,160,243,243,0,2.132,2.132,0.0,272,9,,analises_projeto_lote/adamyap78_ai-kanban_8409a7e_1756614003/before,analises_projeto_lote/adamyap78_ai-kanban_8409a7e_1756614003/after
xlsynth/xlsynth-crate,96e1826f123a70976ee27bcd90b4c52e77fa2191,03bdfae6282f4e420005e6073586c0774b6134b9,cdleary,261,261,73001,73006,5,5371,5372,1,2.802,2.801,-0.001,7,1,7.0,analises_projeto_lote/xlsynth_xlsynth-crate_96e1826_1756614010/before,analises_projeto_lote/xlsynth_xlsynth-crate_96e1826_1756614010/after
xlsynth/xlsynth-crate,03bdfae6282f4e420005e6073586c0774b6134b9,3553bb5adefd7bd9edd007d6a61a7e65127a9ec7,cdleary,260,261,72887,73001,114,5335,5371,36,2.798,2.802,0.004,147,1,4.083,analises_projeto_lote/xlsynth_xlsynth-crate_03bdfae_1756614022/before,analises_projeto_lote/xlsynth_xlsynth-crate_03bdfae_1756614022/after
xlsynth/xlsynth-crate,3553bb5adefd7bd9edd007d6a61a7e65127a9ec7,0fbd4f56fe900a369f6ca510c2c44d97d6cac48a,cdleary,260,260,72868,72887,19,5334,5335,1,2.799,2.798,-0.001,30,4,30.0,analises_projeto_lote/xlsynth_xlsynth-crate_3553bb5_1756614033/before,analises_projeto_lote/xlsynth_xlsynth-crate_3553bb5_1756614033/after
GUESTVALENCIA/SANDRA_IA_7.0,4080ee9f462e91550a2572952e68f2c87d255be1,dc284fd6430747efaee028db1840680616bd9d56,SANDRA IA 8.0 QUANTUM Team,66,66,20684,21173,489,1239,1229,-10,2.104,2.101,-0.003,594,10,59.4,analises_projeto_lote/GUESTVALENCIA_SANDRA_IA_7.0_4080ee9_1756614045/before,analises_projeto_lote/GUESTVALENCIA_SANDRA_IA_7.0_4080ee9_1756614045/after
justinelliottcobb/for-the-union,a5afde93a8595dc5c23450fe0058cab4a89046be,1177a3e55fcd59a0e7967e798021e4e3075bf4da,justinelliottcobb,386,399,136030,142422,6392,13277,14026,749,1.703,1.724,0.021,7490,0,10.0,analises_projeto_lote/justinelliottcobb_for-the-union_a5afde9_1756614052/before,analises_projeto_lote/justinelliottcobb_for-the-union_a5afde9_1756614052/after
hjl2004-10/ai-chat-sillytavern,a967326dc6a866e242c01bcdc5a67d35bff14234,9bbb025f04041e3dac99cb2f4f4f398e4c62bd26,hjl2004-10,16,21,6417,8989,2572,555,752,197,2.456,2.686,0.23,3480,206,17.665,analises_projeto_lote/hjl2004-10_ai-chat-sillytavern_a967326_1756614668/before,analises_projeto_lote/hjl2004-10_ai-chat-sillytavern_a967326_1756614668/after
cjLee-cmd/test_PatAI,cfcdc518dccff7fc453c308958323a83708ace92,6fa0f976f8d451df75a1bc567c69c9d610b35721,cjLee-cmd,39,40,4025,4193,168,224,254,30,2.575,2.731,0.156,723,436,24.1,analises_projeto_lote/cjLee-cmd_test_PatAI_cfcdc51_1756615275/before,analises_projeto_lote/cjLee-cmd_test_PatAI_cfcdc51_1756615275/after
n3rdstyle/data-gems,ac015d2e3a5c76b2b2d48a01a4ca281bdfef06c5,665ba1dfeb95e3b1e8a6b8de760103ee1be91c60,n3rdstyle,19,19,3572,3615,43,414,438,24,3.113,3.269,0.156,61,4,2.542,analises_projeto_lote/n3rdstyle_data-gems_ac015d2_1756615358/before,analises_projeto_lote/n3rdstyle_data-gems_ac015d2_1756615358/after
n3rdstyle/data-gems,665ba1dfeb95e3b1e8a6b8de760103ee1be91c60,a3ddc9d0679ac7419163b6b367704ba67b8fd868,n3rdstyle,19,19,3549,3572,23,405,414,9,3.115,3.113,-0.002,51,16,5.667,analises_projeto_lote/n3rdstyle_data-gems_665ba1d_1756615365/before,analises_projeto_lote/n3rdstyle_data-gems_665ba1d_1756615365/after
n3rdstyle/data-gems,a3ddc9d0679ac7419163b6b367704ba67b8fd868,bf1cc2724d816d8c44f57aba0bfd214b261d0490,n3rdstyle,19,19,3506,3549,43,397,405,8,3.102,3.115,0.013,113,52,14.125,analises_projeto_lote/n3rdstyle_data-gems_a3ddc9d_1756615372/before,analises_projeto_lote/n3rdstyle_data-gems_a3ddc9d_1756615372/after
n3rdstyle/data-gems,bf1cc2724d816d8c44f57aba0bfd214b261d0490,f6eab32014b1a0dd7386cff8b7d12000d78ca883,n3rdstyle,19,19,3500,3506,6,397,397,0,3.102,3.102,0.0,8,2,,analises_projeto_lote/n3rdstyle_data-gems_bf1cc27_1756615378/before,analises_projeto_lote/n3rdstyle_data-gems_bf1cc27_1756615378/after
GUESTVALENCIA/SANDRA_IA_7.0,637e05b7060eee9c8647817e883d46d4738c8510,eee93bf00fb3fa4eee6a86c587ad447f6c681256,SANDRA IA 8.0 QUANTUM Team,61,61,19105,19264,159,1193,1193,0,2.097,2.097,0.0,235,34,,analises_projeto_lote/GUESTVALENCIA_SANDRA_IA_7.0_637e05b_1756615385/before,analises_projeto_lote/GUESTVALENCIA_SANDRA_IA_7.0_637e05b_1756615385/after
voyd-lang/voyd,4a8ccaab95bf31328adba0decfd75d7a6c4d9901,aa62344d2cda6820ab6e2210bbc443c6dde9868c,drew-y,308,309,24185,24300,115,2352,2372,20,1.993,1.997,0.004,137,11,6.85,analises_projeto_lote/voyd-lang_voyd_4a8ccaa_1756615393/before,analises_projeto_lote/voyd-lang_voyd_4a8ccaa_1756615393/after
GUESTVALENCIA/SANDRA_IA_7.0,7c5205f80b4ad060a4aee69bb53f64355f8c1128,b754a0012c4c546125e4f15b656bd87a1d1adcc8,SANDRA IA 8.0 QUANTUM Team,58,52,18645,14666,-3979,957,838,-119,1.994,1.926,-0.068,1309,6281,11.0,analises_projeto_lote/GUESTVALENCIA_SANDRA_IA_7.0_7c5205f_1756615402/before,analises_projeto_lote/GUESTVALENCIA_SANDRA_IA_7.0_7c5205f_1756615402/after
xlsynth/xlsynth-crate,cafa5e91140af1c7ca52053bd95ccb91d9b91466,eda55e3689b29807689dba1bd5b6f336ff2ca005,cdleary,256,258,71408,71591,183,5247,5267,20,2.787,2.788,0.001,208,0,10.4,analises_projeto_lote/xlsynth_xlsynth-crate_cafa5e9_1756616010/before,analises_projeto_lote/xlsynth_xlsynth-crate_cafa5e9_1756616010/after
GUESTVALENCIA/SANDRA_IA_7.0,b754a0012c4c546125e4f15b656bd87a1d1adcc8,536a2460df92d9b88ae372fa1fc32a62dfcb8624,SANDRA IA 8.0 QUANTUM Team,36,58,11582,18645,7063,552,957,405,1.957,1.994,0.037,8894,153,21.96,analises_projeto_lote/GUESTVALENCIA_SANDRA_IA_7.0_b754a00_1756616622/before,analises_projeto_lote/GUESTVALENCIA_SANDRA_IA_7.0_b754a00_1756616622/after
xlsynth/xlsynth-crate,eda55e3689b29807689dba1bd5b6f336ff2ca005,91c3104ecdbfc5c64e9f69991e689acc131dfa01,cdleary,256,256,71431,71408,-23,5253,5247,-6,2.791,2.787,-0.004,20,50,3.333,analises_projeto_lote/xlsynth_xlsynth-crate_eda55e3_1756616630/before,analises_projeto_lote/xlsynth_xlsynth-crate_eda55e3_1756616630/after
voyd-lang/voyd,aa62344d2cda6820ab6e2210bbc443c6dde9868c,124302703fc5a0e276c99884e5060b3b6cb1b978,drew-y,285,308,24118,24185,67,2352,2352,0,1.993,1.993,0.0,874,785,,analises_projeto_lote/voyd-lang_voyd_aa62344_1756632577/before,analises_projeto_lote/voyd-lang_voyd_aa62344_1756632577/after
voyd-lang/voyd,124302703fc5a0e276c99884e5060b3b6cb1b978,3ef92f86c639d85d9572acefec1a670067986224,drew-y,285,285,24102,24118,16,2341,2352,11,1.991,1.993,0.002,34,16,3.091,analises_projeto_lote/voyd-lang_voyd_1243027_1756633195/before,analises_projeto_lote/voyd-lang_voyd_1243027_1756633195/after
xlsynth/xlsynth-crate,91c3104ecdbfc5c64e9f69991e689acc131dfa01,4a98ef14e32cccf8ee83a6dffd0a10bd2a48e8a3,cdleary,256,256,71430,71431,1,5251,5253,2,2.793,2.791,-0.002,21,18,10.5,analises_projeto_lote/xlsynth_xlsynth-crate_91c3104_1756633204/before,analises_projeto_lote/xlsynth_xlsynth-crate_91c3104_1756633204/after
voyd-lang/voyd,3ef92f86c639d85d9572acefec1a670067986224,a9a812385adaf2358497870ca43f78c54a597bd0,drew-y,285,285,24037,24102,65,2336,2341,5,1.993,1.991,-0.002,71,2,14.2,analises_projeto_lote/voyd-lang_voyd_3ef92f8_1756633215/before,analises_projeto_lote/voyd-lang_voyd_3ef92f8_1756633215/after
voyd-lang/voyd,a9a812385adaf2358497870ca43f78c54a597bd0,6dfb5244e1b0335e86169e5d8d83ff75843d16f7,drew-y,285,285,24020,24037,17,2333,2336,3,1.996,1.993,-0.003,20,0,6.667,analises_projeto_lote/voyd-lang_voyd_a9a8123_1756633823/before,analises_projeto_lote/voyd-lang_voyd_a9a8123_1756633823/after
voyd-lang/voyd,6dfb5244e1b0335e86169e5d8d83ff75843d16f7,9cbd349dbfd18e1753eb4c6eaaa3707f2041992f,drew-y,285,285,23969,24020,51,2317,2333,16,1.999,1.996,-0.003,61,3,3.812,analises_projeto_lote/voyd-lang_voyd_6dfb524_1756633832/before,analises_projeto_lote/voyd-lang_voyd_6dfb524_1756633832/after
voyd-lang/voyd,9cbd349dbfd18e1753eb4c6eaaa3707f2041992f,019bbed45e54f6161016ab8aaa05ed9e0e2bb8d2,drew-y,285,285,23989,23969,-20,2317,2317,0,1.999,1.999,0.0,41,63,,analises_projeto_lote/voyd-lang_voyd_9cbd349_1756633840/before,analises_projeto_lote/voyd-lang_voyd_9cbd349_1756633840/after
Ray-Gabe/Gabe-friend-,1ecec4b722232079d3538ef4919b70fbd809974a,18797c12c9fd04423940c8114c796fec217049cc,raylinsami1,160,161,165109,165472,363,1146,1158,12,2.234,2.236,0.002,486,48,40.5,analises_projeto_lote/Ray-Gabe_Gabe-friend-_1ecec4b_1756633849/before,analises_projeto_lote/Ray-Gabe_Gabe-friend-_1ecec4b_1756633849/after
Ray-Gabe/Gabe-friend-,18797c12c9fd04423940c8114c796fec217049cc,d8ca9db6e15540fb27f08a53290c6dbb0e68da8f,raylinsami1,159,160,164938,165109,171,1145,1146,1,2.236,2.234,-0.002,192,0,192.0,analises_projeto_lote/Ray-Gabe_Gabe-friend-_18797c1_1756634128/before,analises_projeto_lote/Ray-Gabe_Gabe-friend-_18797c1_1756634128/after
GUESTVALENCIA/SANDRA_IA_7.0,536a2460df92d9b88ae372fa1fc32a62dfcb8624,e34db08068d733938364486e9df64000535a25fa,SANDRA IA 8.0 QUANTUM Team,36,36,11560,11582,22,552,552,0,1.957,1.957,0.0,77,46,,analises_projeto_lote/GUESTVALENCIA_SANDRA_IA_7.0_536a246_1756640445/before,analises_projeto_lote/GUESTVALENCIA_SANDRA_IA_7.0_536a246_1756640445/after
GUESTVALENCIA/SANDRA_IA_7.0,e34db08068d733938364486e9df64000535a25fa,766f30c627a4e8625df514387edac99fc0ac2a6a,SANDRA IA 8.0 QUANTUM Team,36,36,10021,11560,1539,552,552,0,1.957,1.957,0.0,1825,10,,analises_projeto_lote/GUESTVALENCIA_SANDRA_IA_7.0_e34db08_1756640452/before,analises_projeto_lote/GUESTVALENCIA_SANDRA_IA_7.0_e34db08_1756640452/after
GUESTVALENCIA/SANDRA_IA_7.0,b2bccd9df88ed17a605b585ab003a9fcc1e375f3,9a530ef54850b7018402a06215bf9421a7f39a31,SANDRA IA 8.0 QUANTUM Team,19,37,4279,9718,5439,181,606,425,2.623,1.949,-0.674,6619,18,15.574,analises_projeto_lote/GUESTVALENCIA_SANDRA_IA_7.0_b2bccd9_1756640459/before,analises_projeto_lote/GUESTVALENCIA_SANDRA_IA_7.0_b2bccd9_1756640459/after
Gradual-Load-Testing/gradual,0cbde90e5382cff7a0580e9c0e5272aa6cc3be70,60ce5084bae1e50b2ea62041f1cc3a64b054f3bd,adityakedawat,64,98,2810,6223,3413,258,272,14,1.856,1.915,0.059,4337,2,309.786,analises_projeto_lote/Gradual-Load-Testing_gradual_0cbde90_1756640466/before,analises_projeto_lote/Gradual-Load-Testing_gradual_0cbde90_1756640466/after
GUESTVALENCIA/SANDRA_IA_7.0,9a530ef54850b7018402a06215bf9421a7f39a31,8e762a83ebad4997d5b3e366f389d3110c58fb7b,SANDRA IA 8.0 QUANTUM Team,19,19,4280,4279,-1,190,181,-9,2.5,2.623,0.123,234,215,26.0,analises_projeto_lote/GUESTVALENCIA_SANDRA_IA_7.0_9a530ef_1756640472/before,analises_projeto_lote/GUESTVALENCIA_SANDRA_IA_7.0_9a530ef_1756640472/after
scot00671234/AIForecast-Hub,3f7911164e2bd9232ad94c06cb60d655b7397ab2,209a1002b4b6612328f46445ce774d32b50f9af4,lejecin125,307,310,107413,108142,729,3282,3282,0,3.183,3.183,0.0,1,24,,analises_projeto_lote/scot00671234_AIForecast-Hub_3f79111_1756641079/before,analises_projeto_lote/scot00671234_AIForecast-Hub_3f79111_1756641079/after
brokerelcom/useful_prompts_1,9292f6c38816cbcbac7dbcd528d1e391f24c5716,4940e66573cbaccf66a2edcdde4e7588c4e127e4,asgeirtj,58,59,11471,11479,8,66,66,0,1.347,1.347,0.0,16,0,,analises_projeto_lote/brokerelcom_useful_prompts_1_9292f6c_1756641110/before,analises_projeto_lote/brokerelcom_useful_prompts_1_9292f6c_1756641110/after
luishmcmoreno/DraftGen,a4837561b54e9c3bd71b90a3abdd073c993e48ef,61779db938be2d77ebfdecef371dca27e8478568,Luis H. Moreno,67,67,11508,11649,141,380,393,13,2.262,2.233,-0.029,320,22,24.615,analises_projeto_lote/luishmcmoreno_DraftGen_a483756_1756641118/before,analises_projeto_lote/luishmcmoreno_DraftGen_a483756_1756641118/after
Lawa0921/super_galen_site,a590346206b989a75888116c372407d443ab4649,f4e9f9121c5b8471b17b045098ae81865da157b4,Lawa0921,12,12,12582,12597,15,206,206,0,1.791,1.791,0.0,23,7,,analises_projeto_lote/Lawa0921_super_galen_site_a590346_1756641125/before,analises_projeto_lote/Lawa0921_super_galen_site_a590346_1756641125/after
motoyoshi0107/career-consultant-essay-tool,76af9024014a6f4a2ee38b718a264bf5b6f3a2e8,e36af62f33e45349db3da8d331f52eb346479e2c,motoyoshi0107,4,5,2851,7670,4819,243,243,0,2.531,2.531,0.0,57,0,,analises_projeto_lote/motoyoshi0107_career-consultant-essay-tool_76af902_1756641145/before,analises_projeto_lote/motoyoshi0107_career-consultant-essay-tool_76af902_1756641145/after
Kw0nDY/CPTest,6e2e25899f1146d2214dcf77e7f5a1dd14b2c5cd,e266508e1f9301eb0d92271d8d97a24bdcf3963b,dxtdev,353,354,148073,148187,114,4438,4438,0,2.646,2.646,0.0,146,0,,analises_projeto_lote/Kw0nDY_CPTest_6e2e258_1756641156/before,analises_projeto_lote/Kw0nDY_CPTest_6e2e258_1756641156/after
kawzaiphophu/chat-law-advisor,d875b5b314197897e2abaa0d4f7f30c9c24001b3,444904954e37a6896c865224f80c10b0bc85e801,Alongkon Insuwan,83,85,24155,24332,177,391,418,27,1.312,1.362,0.05,220,9,8.148,analises_projeto_lote/kawzaiphophu_chat-law-advisor_d875b5b_1756641199/before,analises_projeto_lote/kawzaiphophu_chat-law-advisor_d875b5b_1756641199/after
vstram/BrxAgente-desafio4,e907d8bbcceb0ce06b40375916020cc65caca272,31639dde7e56b4307488c5f5c95d306c8b8fbedf,vstram,238,238,49327,49304,-23,5986,5982,-4,3.171,3.163,-0.008,191,229,47.75,analises_projeto_lote/vstram_BrxAgente-desafio4_e907d8b_1756641231/before,analises_projeto_lote/vstram_BrxAgente-desafio4_e907d8b_1756641231/after
ipergamali/mysmartroute,d428aa2848ca241be0f877ffae5f9dc0486a7be5,377bcac2dae28dd5ab40453ce781b1cb101b8490,ipergamali,0,0,0,0,0,0,0,0,0.0,0.0,0.0,8,4,,analises_projeto_lote/ipergamali_mysmartroute_d428aa2_1756641241/before,analises_projeto_lote/ipergamali_mysmartroute_d428aa2_1756641241/after
wyvernkalyx/ai-slop,4f2709d55e80c57ae7f2e2a5f0b8e6b6b1f9a453,6972d953c8c8ba8cb2877dc3dab8665878567b94,wyvernkalyx,29,39,5560,9246,3686,667,943,276,4.067,4.645,0.578,4983,39,18.054,analises_projeto_lote/wyvernkalyx_ai-slop_4f2709d_1756641252/before,analises_projeto_lote/wyvernkalyx_ai-slop_4f2709d_1756641252/after
ipergamali/mysmartroute,377bcac2dae28dd5ab40453ce781b1cb101b8490,d608d608e60bacb02705a95d83ef9dea16788f2b,ipergamali,0,0,0,0,0,0,0,0,0.0,0.0,0.0,1,0,,analises_projeto_lote/ipergamali_mysmartroute_377bcac_1756641258/before,analises_projeto_lote/ipergamali_mysmartroute_377bcac_1756641258/after
remilatoufik1-byte/dark-control-server,9f6f9cf1d40364a933ab58b3e899b6179f1befd7,117591453721b740856ec39aab400219e29b198e,remilatoufik1-byte,11,11,342,344,2,30,32,2,3.0,3.2,0.2,32,29,16.0,analises_projeto_lote/remilatoufik1-byte_dark-control-server_9f6f9cf_1756641268/before,analises_projeto_lote/remilatoufik1-byte_dark-control-server_9f6f9cf_1756641268/after
ipergamali/mysmartroute,c602d9167ed8ac81099ce091adc99680fa327ffa,a8c30d6c03984049a97f9fdd973c7b082e9dd3b1,ipergamali,0,0,0,0,0,0,0,0,0.0,0.0,0.0,5,4,,analises_projeto_lote/ipergamali_mysmartroute_c602d91_1756641274/before,analises_projeto_lote/ipergamali_mysmartroute_c602d91_1756641274/after
ipergamali/mysmartroute,a8c30d6c03984049a97f9fdd973c7b082e9dd3b1,9a96502a7d0e50c16896d29c8a5330ae3941e6fe,ipergamali,0,0,0,0,0,0,0,0,0.0,0.0,0.0,1,4,,analises_projeto_lote/ipergamali_mysmartroute_a8c30d6_1756641284/before,analises_projeto_lote/ipergamali_mysmartroute_a8c30d6_1756641284/after
ipergamali/mysmartroute,9a96502a7d0e50c16896d29c8a5330ae3941e6fe,370f8646c43bf344b2fdcdb913de21dd46709dac,ipergamali,0,0,0,0,0,0,0,0,0.0,0.0,0.0,4,5,,analises_projeto_lote/ipergamali_mysmartroute_9a96502_1756641295/before,analises_projeto_lote/ipergamali_mysmartroute_9a96502_1756641295/after
kevinveenbirkenbach/infinito-nexus,6ea8301364e735ae3135afe2d854ff87ab99a121,92f5bf648107bdc6467777618e9f6f6e88ce8035,kevinveenbirkenbach,1872,1872,56575,56575,0,3498,3498,0,3.328,3.328,0.0,112,114,,analises_projeto_lote/kevinveenbirkenbach_infinito-nexus_6ea8301_1756641306/before,analises_projeto_lote/kevinveenbirkenbach_infinito-nexus_6ea8301_1756641306/after
ipergamali/mysmartroute,370f8646c43bf344b2fdcdb913de21dd46709dac,7f6c4718ae9af2fe0981e283ef85bb60edf8c25d,ipergamali,0,0,0,0,0,0,0,0,0.0,0.0,0.0,1,0,,analises_projeto_lote/ipergamali_mysmartroute_370f864_1756641321/before,analises_projeto_lote/ipergamali_mysmartroute_370f864_1756641321/after
remilatoufik1-byte/dark-control-server,abd4d08c3c5d94edc613f7962be2d7f7d53d4ebd,fd808c80e201df659545308ea130a6d8a9157775,remilatoufik1-byte,11,11,382,387,5,30,30,0,2.5,2.5,0.0,32,25,,analises_projeto_lote/remilatoufik1-byte_dark-control-server_abd4d08_1756641331/before,analises_projeto_lote/remilatoufik1-byte_dark-control-server_abd4d08_1756641331/after
mugijiru/.emacs.d,63b16f8948b6b4b44202c3c5faed154e3e08309b,e5d0f77615ff85909ff829378a18d5d1bb480efe,mugijiru,893,893,321210,321210,0,1076,1076,0,1.915,1.915,0.0,1,1,,analises_projeto_lote/mugijiru_.emacs.d_63b16f8_1756641337/before,analises_projeto_lote/mugijiru_.emacs.d_63b16f8_1756641337/after
ipergamali/mysmartroute,7f6c4718ae9af2fe0981e283ef85bb60edf8c25d,0c39dfb9be4dbf75510b42fc756cbf42339153b7,ipergamali,0,0,0,0,0,0,0,0,0.0,0.0,0.0,0,4,,analises_projeto_lote/ipergamali_mysmartroute_7f6c471_1756641438/before,analises_projeto_lote/ipergamali_mysmartroute_7f6c471_1756641438/after
remilatoufik1-byte/dark-control-server,575f2d3db1ebb7258d425a47b59ce9e45dedcf0e,df7d9105a8af5b1d621958c08d18f0a11750c435,remilatoufik1-byte,11,11,364,363,-1,32,32,0,2.667,2.667,0.0,13,14,,analises_projeto_lote/remilatoufik1-byte_dark-control-server_575f2d3_1756641448/before,analises_projeto_lote/remilatoufik1-byte_dark-control-server_575f2d3_1756641448/after
ipergamali/mysmartroute,0c39dfb9be4dbf75510b42fc756cbf42339153b7,5069ab6b285cfb6f9a412f0cf7c1f4939af85330,ipergamali,0,0,0,0,0,0,0,0,0.0,0.0,0.0,5,6,,analises_projeto_lote/ipergamali_mysmartroute_0c39dfb_1756641454/before,analises_projeto_lote/ipergamali_mysmartroute_0c39dfb_1756641454/after
kevinveenbirkenbach/infinito-nexus,92f5bf648107bdc6467777618e9f6f6e88ce8035,58c17bf04388c2344285d8e03b93a6e8406685a9,kevinveenbirkenbach,1872,1872,56611,56575,-36,3498,3498,0,3.328,3.328,0.0,68,116,,analises_projeto_lote/kevinveenbirkenbach_infinito-nexus_92f5bf6_1756641464/before,analises_projeto_lote/kevinveenbirkenbach_infinito-nexus_92f5bf6_1756641464/after
kevinveenbirkenbach/infinito-nexus,58c17bf04388c2344285d8e03b93a6e8406685a9,6c2d5c52c80d5312f9d3cea83f42daac9ade4094,kevinveenbirkenbach,1870,1872,56553,56611,58,3498,3498,0,3.328,3.328,0.0,98,19,,analises_projeto_lote/kevinveenbirkenbach_infinito-nexus_58c17bf_1756641477/before,analises_projeto_lote/kevinveenbirkenbach_infinito-nexus_58c17bf_1756641477/after
contestra/ai-ranker-v2,7ffb84b8a934194668167df10ffa58e6cd7bb52b,0e605e0ad6040b2ddc8eb88667a1cab68044db41,contestra,188,189,33424,33403,-21,2253,2241,-12,3.223,3.188,-0.035,428,440,35.667,analises_projeto_lote/contestra_ai-ranker-v2_7ffb84b_1756641490/before,analises_projeto_lote/contestra_ai-ranker-v2_7ffb84b_1756641490/after
mlynnf123/scriptorumbra2,5c9f3351e9bacf98141603db749d69b6ed48b681,a5cff635bd298c6beafb7a833022320be281955f,mlynnf123,147,149,38821,38816,-5,981,965,-16,1.712,1.711,-0.001,137,123,8.562,analises_projeto_lote/mlynnf123_scriptorumbra2_5c9f335_1756641499/before,analises_projeto_lote/mlynnf123_scriptorumbra2_5c9f335_1756641499/after
ipergamali/mysmartroute,5069ab6b285cfb6f9a412f0cf7c1f4939af85330,f4d155612cdee4fa2f0d352d09b0e223e2cd947e,ipergamali,0,0,0,0,0,0,0,0,0.0,0.0,0.0,2,1,,analises_projeto_lote/ipergamali_mysmartroute_5069ab6_1756641507/before,analises_projeto_lote/ipergamali_mysmartroute_5069ab6_1756641507/after
tayler-id/tayler_id_portfolio_redesign_final,e810efbf441ea46446a46122c2d647a17e476099,03e889d252b4c823c8108b4ac37db0a950917d34,Tayler Ramsay,73,109,78059,90042,11983,297,540,243,1.892,1.882,-0.01,14077,0,57.93,analises_projeto_lote/tayler-id_tayler_id_portfolio_redesign_final_e810efb_1756641517/before,analises_projeto_lote/tayler-id_tayler_id_portfolio_redesign_final_e810efb_1756641517/after
ipergamali/mysmartroute,f4d155612cdee4fa2f0d352d09b0e223e2cd947e,fbecb2fe4b6a169df09f5f48773aaa45aecd877c,ipergamali,0,0,0,0,0,0,0,0,0.0,0.0,0.0,9,9,,analises_projeto_lote/ipergamali_mysmartroute_f4d1556_1756641541/before,analises_projeto_lote/ipergamali_mysmartroute_f4d1556_1756641541/after
ipergamali/mysmartroute,fbecb2fe4b6a169df09f5f48773aaa45aecd877c,1e39e62965bac6cdc38ed497ece15173251a24f4,ipergamali,0,0,0,0,0,0,0,0,0.0,0.0,0.0,6,7,,analises_projeto_lote/ipergamali_mysmartroute_fbecb2f_1756641552/before,analises_projeto_lote/ipergamali_mysmartroute_fbecb2f_1756641552/after
contestra/ai-ranker-v2,0e605e0ad6040b2ddc8eb88667a1cab68044db41,3c3de8c4673b0a45f455fde63c7729b2b503c3e4,contestra,191,188,34251,33424,-827,2439,2253,-186,3.369,3.223,-0.146,822,1933,4.419,analises_projeto_lote/contestra_ai-ranker-v2_0e605e0_1756641562/before,analises_projeto_lote/contestra_ai-ranker-v2_0e605e0_1756641562/after
contestra/ai-ranker-v2,3c3de8c4673b0a45f455fde63c7729b2b503c3e4,5892cc334bf47e52b7134a233d473caa1f7d9929,contestra,184,191,33028,34251,1223,2261,2439,178,3.32,3.369,0.049,1725,14,9.691,analises_projeto_lote/contestra_ai-ranker-v2_3c3de8c_1756641571/before,analises_projeto_lote/contestra_ai-ranker-v2_3c3de8c_1756641571/after
remilatoufik1-byte/dark-control-server,12ad71b219abeaf3716f750e87a627f6733c62ad,6459b2c2bd98884f4d19db307414dc45d9ccf339,remilatoufik1-byte,10,10,334,329,-5,31,29,-2,2.818,2.636,-0.182,13,18,6.5,analises_projeto_lote/remilatoufik1-byte_dark-control-server_12ad71b_1756641579/before,analises_projeto_lote/remilatoufik1-byte_dark-control-server_12ad71b_1756641579/after
kevinveenbirkenbach/infinito-nexus,9f2cfe65afabc5a9a0bdbb8b2a55b80c8ab792e7,fe399c39675833d3d36312ce3a0d8308239beb85,kevinveenbirkenbach,1879,1870,57238,56550,-688,3582,3498,-84,3.329,3.328,-0.001,15,947,0.179,analises_projeto_lote/kevinveenbirkenbach_infinito-nexus_9f2cfe6_1756641585/before,analises_projeto_lote/kevinveenbirkenbach_infinito-nexus_9f2cfe6_1756641585/after
zabsonrekalifa4-netizen/Comparatif-EUR-USD-,9bf566138075175be5a6e21e7a84254258db0b33,5d8ba3ecec69f16e757a6353281005013bc227ca,zabsonrekalifa4-netizen,1,1,1,120,119,0,3,3,0.0,3.0,3.0,128,1,42.667,analises_projeto_lote/zabsonrekalifa4-netizen_Comparatif-EUR-USD-_9bf5661_1756641599/before,analises_projeto_lote/zabsonrekalifa4-netizen_Comparatif-EUR-USD-_9bf5661_1756641599/after
unfoldingWord/bt-servant-engine,0c54618381670dd50949a186abb76d45ba97359f,88263db5526268b8165f72c74764983cfe53ca3a,IanLindsley,25,25,4205,4303,98,223,224,1,2.593,2.575,-0.018,318,205,318.0,analises_projeto_lote/unfoldingWord_bt-servant-engine_0c54618_1756641604/before,analises_projeto_lote/unfoldingWord_bt-servant-engine_0c54618_1756641604/after
HartfordAI/AIApiConnect,d57a094e595520d1936dc23bfc5b9c5b25de09a2,c9da8e7df895a9793bd7514338bd275b94e2764b,JamieSnyder,71,71,13500,13501,1,406,406,0,1.327,1.327,0.0,2,1,,analises_projeto_lote/HartfordAI_AIApiConnect_d57a094_1756641612/before,analises_projeto_lote/HartfordAI_AIApiConnect_d57a094_1756641612/after
HartfordAI/AIApiConnect,c9da8e7df895a9793bd7514338bd275b94e2764b,4ac8d2ef6ec8d3273316d8e2a379654d7dc060d5,JamieSnyder,71,71,13508,13500,-8,414,406,-8,1.353,1.327,-0.026,74,169,9.25,analises_projeto_lote/HartfordAI_AIApiConnect_c9da8e7_1756641619/before,analises_projeto_lote/HartfordAI_AIApiConnect_c9da8e7_1756641619/after
Dhuruvm/OsidaiMVP,865d8e9c4217afea412dae31ab4b6a1e35c09f28,11ff2be9768ec25aed0660853569c30eb72b24aa,przmoofficial,11,19,1229,4644,3415,131,148,17,1.819,1.783,-0.036,844,599,49.647,analises_projeto_lote/Dhuruvm_OsidaiMVP_865d8e9_1756641626/before,analises_projeto_lote/Dhuruvm_OsidaiMVP_865d8e9_1756641626/after
Emirchelo-Lopez/chatgpt-clone,d759856474d2c2c5f94bd24d65e2d3df56d1b087,f4c13935514716276b3b75cf8b194677c040217e,Emirchelo-Lopez,67,67,3563,3579,16,184,184,0,1.496,1.496,0.0,18,0,,analises_projeto_lote/Emirchelo-Lopez_chatgpt-clone_d759856_1756641634/before,analises_projeto_lote/Emirchelo-Lopez_chatgpt-clone_d759856_1756641634/after
StanfordSpezi/spezi-firebase,f7c9df2890cbbefff4a55e1f2629d06e57a76afb,997fd6be9c501a9e0c7d55740a5a40d02cc0bcf1,pauljohanneskraft,178,190,47698,48699,1001,561,573,12,1.171,1.167,-0.004,1080,10,90.0,analises_projeto_lote/StanfordSpezi_spezi-firebase_f7c9df2_1756641651/before,analises_projeto_lote/StanfordSpezi_spezi-firebase_f7c9df2_1756641651/after
kevinveenbirkenbach/infinito-nexus,ef801aa49862d34a9a4a3e803488f7525d18794a,18f3b1042fb8f9526c11377d12d48babb77bb9a4,kevinveenbirkenbach,1872,1875,56659,56809,150,3500,3538,38,3.324,3.36,0.036,326,119,8.579,analises_projeto_lote/kevinveenbirkenbach_infinito-nexus_ef801aa_1756641660/before,analises_projeto_lote/kevinveenbirkenbach_infinito-nexus_ef801aa_1756641660/after
cubica/crashbaggage-smart-links,629ee0f44c3a175252617600780bb56f14a1a9b4,677abf83d8fc653384bdb56348b2577c2b862ee2,qrade,9,10,2248,2513,265,26,79,53,2.0,2.469,0.469,624,234,11.774,analises_projeto_lote/cubica_crashbaggage-smart-links_629ee0f_1756641673/before,analises_projeto_lote/cubica_crashbaggage-smart-links_629ee0f_1756641673/after
getzep/graphiti,03350335cdb184e7e122c01359f292e037b08b13,8802b7db1325abb075836836b12a37741984b1a5,jackaldenryan,165,165,109408,109414,6,2039,2039,0,3.326,3.326,0.0,7,0,,analises_projeto_lote/getzep_graphiti_0335033_1756641679/before,analises_projeto_lote/getzep_graphiti_0335033_1756641679/after
ittanez/kickstart-hypno-test,010877e83b900484e8c5d5007eb67182674b1379,187a419ee3faa2f876311420d407654762c94def,ittanez,133,138,34410,35040,630,638,638,0,1.375,1.375,0.0,741,3,,analises_projeto_lote/ittanez_kickstart-hypno-test_010877e_1756641707/before,analises_projeto_lote/ittanez_kickstart-hypno-test_010877e_1756641707/after
PetrAnto/checklist,9ea3884b403a3391598c7f7afdf6fa0895dc3ae5,3094f580f1ca10a251cedbb13d8e30e33d8c7920,PetrAnto,2,2,5817,5901,84,9,9,0,1.8,1.8,0.0,116,19,,analises_projeto_lote/PetrAnto_checklist_9ea3884_1756641731/before,analises_projeto_lote/PetrAnto_checklist_9ea3884_1756641731/after
kevinveenbirkenbach/infinito-nexus,18f3b1042fb8f9526c11377d12d48babb77bb9a4,dece6228a4cc2a51921975d692acc7f775daa511,kevinveenbirkenbach,1865,1872,56369,56659,290,3489,3500,11,3.342,3.324,-0.018,351,16,31.909,analises_projeto_lote/kevinveenbirkenbach_infinito-nexus_18f3b10_1756641738/before,analises_projeto_lote/kevinveenbirkenbach_infinito-nexus_18f3b10_1756641738/after
splinter93/abrege,dc36b860ddf982fd35537fff9241a290ced83d52,c1c8bbf4bae97330ce67a3af627221238f2e4665,splinter93,1340,1340,206858,206863,5,11158,11159,1,1.842,1.842,0.0,12,6,12.0,analises_projeto_lote/splinter93_abrege_dc36b86_1756641751/before,analises_projeto_lote/splinter93_abrege_dc36b86_1756641751/after
matlukowski/readTube,c78d084a2f592bdd4f25caeb863768de73990dbb,2c19c48b660da6acc9f5f1731ecc8ab63f55d913,matlukowski,70,68,14287,14094,-193,543,526,-17,1.967,1.963,-0.004,339,975,19.941,analises_projeto_lote/matlukowski_readTube_c78d084_1756642370/before,analises_projeto_lote/matlukowski_readTube_c78d084_1756642370/after
Charcoal-SE/SmokeDetector,1e6610838fbaebfeee6119d547bea2d9dbc15a88,8723e9f04c1ab9974e15f3cb8e488cd008164edb,SmokeDetector,87,87,128648,128649,1,2862,2862,0,3.826,3.826,0.0,1,0,,analises_projeto_lote/Charcoal-SE_SmokeDetector_1e66108_1756642378/before,analises_projeto_lote/Charcoal-SE_SmokeDetector_1e66108_1756642378/after
Charcoal-SE/SmokeDetector,cb17b2a18ed9e9f7f3d282409feae1db00440e39,79e9aff11f8d5db94d5b4d998a8aba221fc217fd,SmokeDetector,87,87,128648,128647,-1,2862,2862,0,3.826,3.826,0.0,0,1,,analises_projeto_lote/Charcoal-SE_SmokeDetector_cb17b2a_1756642628/before,analises_projeto_lote/Charcoal-SE_SmokeDetector_cb17b2a_1756642628/after
Charcoal-SE/SmokeDetector,79e9aff11f8d5db94d5b4d998a8aba221fc217fd,c72d6644fd94140b1ffe788cfa9dbdf0649e3952,SmokeDetector,87,87,128647,128648,1,2862,2862,0,3.826,3.826,0.0,1,0,,analises_projeto_lote/Charcoal-SE_SmokeDetector_79e9aff_1756642881/before,analises_projeto_lote/Charcoal-SE_SmokeDetector_79e9aff_1756642881/after
EVERLIV/HealthMind,d3301ce9030be40e60f7672ecd3c2463c3e955d7,4714ab056765aa75b0db32023a60b7c4698220ab,wewa666,160,161,149491,149595,104,1433,1438,5,1.918,1.92,0.002,178,27,35.6,analises_projeto_lote/EVERLIV_HealthMind_d3301ce_1756643132/before,analises_projeto_lote/EVERLIV_HealthMind_d3301ce_1756643132/after
HumanSignal/Adala,4228ad1d871c979adfe180dafe47367b233556d4,dceb4a7a974cfab16df570850db99e3d07267fc9,niklub,163,165,62530,62875,345,1052,1063,11,2.617,2.618,0.001,408,1,37.091,analises_projeto_lote/HumanSignal_Adala_4228ad1_1756643369/before,analises_projeto_lote/HumanSignal_Adala_4228ad1_1756643369/after
velijoze/godspeed-theme,be1894ce5316a5277b5d631ac4259489247bcbad,bf63576cd35206d148cd0a6ad409cc000b633790,velijoze,354,355,127558,128842,1284,1351,1357,6,2.374,2.364,-0.01,1438,19,239.667,analises_projeto_lote/velijoze_godspeed-theme_be1894c_1756643380/before,analises_projeto_lote/velijoze_godspeed-theme_be1894c_1756643380/after
quartermasters/Nudge-AI-Chatbot,91de9b298694537c2eee4bf11767d38896c70258,a2514193b86c0ebbbf7154830e5f02bca56f13da,aliffcapital,86,86,15497,15491,-6,473,474,1,1.314,1.317,0.003,40,22,40.0,analises_projeto_lote/quartermasters_Nudge-AI-Chatbot_91de9b2_1756643397/before,analises_projeto_lote/quartermasters_Nudge-AI-Chatbot_91de9b2_1756643397/after
OpenTermsArchive/GenAI-snapshots,b68d0fe87d7caaf3163fcc34e279f20d84e3d888,65b3a3918fc19c62ce15fb7be9c1c75ad8d43270,OTA-Bot,157,157,67750,67750,0,4492,4492,0,3.909,3.909,0.0,2,2,,analises_projeto_lote/OpenTermsArchive_GenAI-snapshots_b68d0fe_1756643404/before,analises_projeto_lote/OpenTermsArchive_GenAI-snapshots_b68d0fe_1756643404/after
OpenTermsArchive/GenAI-snapshots,65b3a3918fc19c62ce15fb7be9c1c75ad8d43270,4ab02a0c3d355a2d6e2aa30b5c693f1c70fdf5f8,OTA-Bot,157,157,67750,67750,0,4492,4492,0,3.909,3.909,0.0,2,2,,analises_projeto_lote/OpenTermsArchive_GenAI-snapshots_65b3a39_1756643452/before,analises_projeto_lote/OpenTermsArchive_GenAI-snapshots_65b3a39_1756643452/after
OpenTermsArchive/GenAI-snapshots,4ab02a0c3d355a2d6e2aa30b5c693f1c70fdf5f8,f4505b17fe456bbb1de44ba8ae7a9ac55b82c1e6,OTA-Bot,157,157,67750,67750,0,4492,4492,0,3.909,3.909,0.0,2,2,,analises_projeto_lote/OpenTermsArchive_GenAI-snapshots_4ab02a0_1756643499/before,analises_projeto_lote/OpenTermsArchive_GenAI-snapshots_4ab02a0_1756643499/after
OpenTermsArchive/GenAI-snapshots,f4505b17fe456bbb1de44ba8ae7a9ac55b82c1e6,5bd973884faa45e46cbc6c0f8f8fbf64a2cba8da,OTA-Bot,157,157,67750,67750,0,4492,4492,0,3.909,3.909,0.0,2,2,,analises_projeto_lote/OpenTermsArchive_GenAI-snapshots_f4505b1_1756643546/before,analises_projeto_lote/OpenTermsArchive_GenAI-snapshots_f4505b1_1756643546/after
OpenTermsArchive/GenAI-snapshots,df28ed243aa4106a373182757779da27adfd301e,c45587de5636ddfd1bf01ba31eec26f465b60eea,OTA-Bot,157,157,67750,67750,0,4492,4492,0,3.909,3.909,0.0,2,2,,analises_projeto_lote/OpenTermsArchive_GenAI-snapshots_df28ed2_1756643593/before,analises_projeto_lote/OpenTermsArchive_GenAI-snapshots_df28ed2_1756643593/after
OpenTermsArchive/GenAI-snapshots,5bd973884faa45e46cbc6c0f8f8fbf64a2cba8da,df28ed243aa4106a373182757779da27adfd301e,OTA-Bot,157,157,67750,67750,0,4492,4492,0,3.909,3.909,0.0,2,2,,analises_projeto_lote/OpenTermsArchive_GenAI-snapshots_5bd9738_1756643643/before,analises_projeto_lote/OpenTermsArchive_GenAI-snapshots_5bd9738_1756643643/after
OpenTermsArchive/GenAI-snapshots,c45587de5636ddfd1bf01ba31eec26f465b60eea,e438e4cf5084ca2ed22505f1143f44b9d894a47f,OTA-Bot,157,157,67750,67750,0,4492,4492,0,3.909,3.909,0.0,2,2,,analises_projeto_lote/OpenTermsArchive_GenAI-snapshots_c45587d_1756643689/before,analises_projeto_lote/OpenTermsArchive_GenAI-snapshots_c45587d_1756643689/after
OpenTermsArchive/GenAI-snapshots,e438e4cf5084ca2ed22505f1143f44b9d894a47f,b07c5b52143f4a03e094c1e662f4f41190f91752,OTA-Bot,157,157,67750,67750,0,4492,4492,0,3.909,3.909,0.0,2,2,,analises_projeto_lote/OpenTermsArchive_GenAI-snapshots_e438e4c_1756643737/before,analises_projeto_lote/OpenTermsArchive_GenAI-snapshots_e438e4c_1756643737/after
OpenTermsArchive/GenAI-snapshots,b07c5b52143f4a03e094c1e662f4f41190f91752,27be5b87f7d18c2fcfc1e8c63cceda909af8dd6c,OTA-Bot,157,157,67750,67750,0,4492,4492,0,3.909,3.909,0.0,,,,analises_projeto_lote/OpenTermsArchive_GenAI-snapshots_b07c5b5_1756643787/before,analises_projeto_lote/OpenTermsArchive_GenAI-snapshots_b07c5b5_1756643787/after
ni/open-source,04c76b2fa932e6069344dfc792b6b02ac20a9d8b,cf0a55ab8fdc582d228ad4e8e4fc89264822d052,svelderrainruiz,74,74,4385,4385,0,119,119,0,1.214,1.214,0.0,93,54,,analises_projeto_lote/ni_open-source_04c76b2_1756646781/before,analises_projeto_lote/ni_open-source_04c76b2_1756646781/after
ni/open-source,55c8df0959249d873be7926955d1571c0fffc418,38241ca9770bd03ba61b96f5afe51cad9ef940c8,svelderrainruiz,74,74,4385,4385,0,119,119,0,1.214,1.214,0.0,2,0,,analises_projeto_lote/ni_open-source_55c8df0_1756646788/before,analises_projeto_lote/ni_open-source_55c8df0_1756646788/after
TristanNguyen04/C4T6-HotelBooking,da12c076826f3ff0a7d5aea7d78a4e4bde5c59f2,397910f4ccf8219b8f747c2fe8bcf7937bfa68f9,TristanNguyen04,278,295,189925,195360,5435,1943,2023,80,1.823,1.77,-0.053,6288,97,78.6,analises_projeto_lote/TristanNguyen04_C4T6-HotelBooking_da12c07_1756646796/before,analises_projeto_lote/TristanNguyen04_C4T6-HotelBooking_da12c07_1756646796/after
TristanNguyen04/C4T6-HotelBooking,f0da0b4e5e30cbe485bbed35fe6acb44a03f30e9,72450f05def329ac79ce0dbd2e473ebc67e85861,TristanNguyen04,278,278,189925,189925,0,1943,1943,0,1.823,1.823,0.0,0,0,,analises_projeto_lote/TristanNguyen04_C4T6-HotelBooking_f0da0b4_1756646970/before,analises_projeto_lote/TristanNguyen04_C4T6-HotelBooking_f0da0b4_1756646970/after
TristanNguyen04/C4T6-HotelBooking,72450f05def329ac79ce0dbd2e473ebc67e85861,867fa34a9187be8753875fa3e5bf3672eb63c60f,TristanNguyen04,276,278,189954,189925,-29,1943,1943,0,1.823,1.823,0.0,69,105,,analises_projeto_lote/TristanNguyen04_C4T6-HotelBooking_72450f0_1756647140/before,analises_projeto_lote/TristanNguyen04_C4T6-HotelBooking_72450f0_1756647140/after
ni/open-source,55242bc1d8c16365c54407685558b5ebfe26bda7,4acb80d4a3662e32f592d4acb7523dba6258a858,svelderrainruiz,74,74,4385,4385,0,119,119,0,1.214,1.214,0.0,3,4,,analises_projeto_lote/ni_open-source_55242bc_1756647312/before,analises_projeto_lote/ni_open-source_55242bc_1756647312/after
ni/open-source,a776e2936300dec0d8fa44eb18779aa55aba10f6,9c399cbfa643b8724b6ff95f0d959594d0364de8,svelderrainruiz,74,74,4385,4385,0,119,119,0,1.214,1.214,0.0,1,1,,analises_projeto_lote/ni_open-source_a776e29_1756647319/before,analises_projeto_lote/ni_open-source_a776e29_1756647319/after
ni/open-source,9c399cbfa643b8724b6ff95f0d959594d0364de8,80a877941aee3a6f96563e5751fe36b851523a25,svelderrainruiz,74,74,4385,4385,0,119,119,0,1.214,1.214,0.0,6,6,,analises_projeto_lote/ni_open-source_9c399cb_1756647327/before,analises_projeto_lote/ni_open-source_9c399cb_1756647327/after
ni/open-source,80a877941aee3a6f96563e5751fe36b851523a25,0d4cae272945e6533627a369aaa4de03f128790c,svelderrainruiz,74,74,4384,4385,1,119,119,0,1.214,1.214,0.0,1,0,,analises_projeto_lote/ni_open-source_80a8779_1756647334/before,analises_projeto_lote/ni_open-source_80a8779_1756647334/after
sublang-ai/tigs,2c8dce1d73cfcfac892351178d3fcb40ac0dc81a,8d2ce0de89f08bd6f0f3d9e5c51e988f1720d052,basicthinker,15,15,1156,1160,4,69,69,0,1.769,1.769,0.0,27,23,,analises_projeto_lote/sublang-ai_tigs_2c8dce1_1756647341/before,analises_projeto_lote/sublang-ai_tigs_2c8dce1_1756647341/after
ni/open-source,0d4cae272945e6533627a369aaa4de03f128790c,5dd4d7e0d7c30984308dce55863257b1845eaa1b,svelderrainruiz,74,74,4384,4384,0,119,119,0,1.214,1.214,0.0,1,1,,analises_projeto_lote/ni_open-source_0d4cae2_1756647348/before,analises_projeto_lote/ni_open-source_0d4cae2_1756647348/after
ni/open-source,5dd4d7e0d7c30984308dce55863257b1845eaa1b,9d316678bc590eef1169bf3b11500e03a7725de7,svelderrainruiz,74,74,4384,4384,0,119,119,0,1.214,1.214,0.0,15,15,,analises_projeto_lote/ni_open-source_5dd4d7e_1756647355/before,analises_projeto_lote/ni_open-source_5dd4d7e_1756647355/after
ChrisT19931/VentaroAI8.4,45bf5c44fe7a85eb00dcdccb14ef67ec11c06a95,6e76e5adeb9c423b00a539a14d480a147ac37980,ChrisT19931,493,493,95713,96184,471,6909,6901,-8,2.371,2.371,0.0,774,345,96.75,analises_projeto_lote/ChrisT19931_VentaroAI8.4_45bf5c4_1756647362/before,analises_projeto_lote/ChrisT19931_VentaroAI8.4_45bf5c4_1756647362/after
ChrisT19931/VentaroAI10,45bf5c44fe7a85eb00dcdccb14ef67ec11c06a95,6e76e5adeb9c423b00a539a14d480a147ac37980,ChrisT19931,493,493,95713,96184,471,6909,6901,-8,2.371,2.371,0.0,774,345,96.75,analises_projeto_lote/ChrisT19931_VentaroAI10_45bf5c4_1756647377/before,analises_projeto_lote/ChrisT19931_VentaroAI10_45bf5c4_1756647377/after
ni/open-source,9d316678bc590eef1169bf3b11500e03a7725de7,08833fff1caf85784d9f54a369d5de2ea1bafec4,svelderrainruiz,74,74,4384,4384,0,119,119,0,1.214,1.214,0.0,1,1,,analises_projeto_lote/ni_open-source_9d31667_1756647392/before,analises_projeto_lote/ni_open-source_9d31667_1756647392/after
ni/open-source,08833fff1caf85784d9f54a369d5de2ea1bafec4,ae438874194bf2047c511002292593cf8612ec12,svelderrainruiz,73,74,4160,4384,224,119,119,0,1.214,1.214,0.0,294,23,,analises_projeto_lote/ni_open-source_08833ff_1756647399/before,analises_projeto_lote/ni_open-source_08833ff_1756647399/after
ni/open-source,822fe70cac62152e4cc22f88eed956fe2afb6086,9ea25d0223d4f783d13a68895dae015a8fee928a,svelderrainruiz,74,74,4383,4384,1,119,119,0,1.214,1.214,0.0,39,38,,analises_projeto_lote/ni_open-source_822fe70_1756647407/before,analises_projeto_lote/ni_open-source_822fe70_1756647407/after
ni/open-source,ae438874194bf2047c511002292593cf8612ec12,42d3b67d6c5504ce518ab971453b189f432726c4,svelderrainruiz,73,73,4142,4160,18,119,119,0,1.214,1.214,0.0,2,0,,analises_projeto_lote/ni_open-source_ae43887_1756647414/before,analises_projeto_lote/ni_open-source_ae43887_1756647414/after
ni/open-source,42d3b67d6c5504ce518ab971453b189f432726c4,5efb0c5e6edcf49e370e2d427ad62c9c3d700c7a,svelderrainruiz,73,73,4140,4142,2,119,119,0,1.214,1.214,0.0,4,0,,analises_projeto_lote/ni_open-source_42d3b67_1756647421/before,analises_projeto_lote/ni_open-source_42d3b67_1756647421/after
cvcobb001/writerr-1.0,26a97a20e4eac329be48e63b39003339d2ae51c7,cf4c1e6b2f67e08ba0edd92efd50342e2af14b81,cvcobb001,103,103,68404,68879,475,2279,2244,-35,1.648,1.651,0.003,752,225,21.486,analises_projeto_lote/cvcobb001_writerr-1.0_26a97a2_1756647429/before,analises_projeto_lote/cvcobb001_writerr-1.0_26a97a2_1756647429/after
darkzOGx/debt-clear,83bb59a90784b6774fe2c3efacdda834bdb7d150,357b74ee26321d86e019bd3c9cc872a90a8bfa78,darkzOGx,255,267,57894,60810,2916,1232,1289,57,1.783,1.759,-0.024,3497,16,61.351,analises_projeto_lote/darkzOGx_debt-clear_83bb59a_1756647564/before,analises_projeto_lote/darkzOGx_debt-clear_83bb59a_1756647564/after
EBB1973/Oce-me---The-Vividus---Message-to-Humans-and-AIs,43cda68e4564772157bcb1f967522b28981879f9,ee50c675af15832c3711dea6c7a9791aae9eba9a,EBB1973,42,43,38992,39228,236,8,8,0,4.0,4.0,0.0,0,0,,analises_projeto_lote/EBB1973_Oce-me---The-Vividus---Message-to-Humans-and-AIs_43cda68_1756647574/before,analises_projeto_lote/EBB1973_Oce-me---The-Vividus---Message-to-Humans-and-AIs_43cda68_1756647574/after
FIXO-FOP-638/Fixophixo638-fop638.onmicrosoft.com,e15e9d23d175640b5f9ca6979721a2c5846f4480,0021598ada7fe0bce31d01cbc52b05f50335d8d2,PhixoR13,2,3,172,2114,1942,0,0,0,0.0,0.0,0.0,2306,0,,analises_projeto_lote/FIXO-FOP-638_Fixophixo638-fop638.onmicrosoft.com_e15e9d2_1756647588/before,analises_projeto_lote/FIXO-FOP-638_Fixophixo638-fop638.onmicrosoft.com_e15e9d2_1756647588/after
dave-hillier/instascript,e3c5e5087ba669066c51da23b4610418157b3af3,709a69d8edce57e354467a9fba04d912a01332a7,dave-hillier,52,52,4985,4979,-6,581,580,-1,2.105,2.101,-0.004,5,11,5.0,analises_projeto_lote/dave-hillier_instascript_e3c5e50_1756647593/before,analises_projeto_lote/dave-hillier_instascript_e3c5e50_1756647593/after
samogden/helpful-scripts,5f55e64696fd991777a784949cd422a642890efc,e57a1e682514855028e533f31298d91423c429fe,samogden,31,31,3106,3162,56,374,400,26,3.066,3.175,0.109,121,76,4.654,analises_projeto_lote/samogden_helpful-scripts_5f55e64_1756647600/before,analises_projeto_lote/samogden_helpful-scripts_5f55e64_1756647600/after
Creativemena007/BibleScholar,065beb36c7d0a3724e5b53959b8ff27d51394b93,832f841b31ccbc5ff04bd02335f59086fa9f4ee9,Creativemena007,1,19,19,4691,4672,0,27,27,0.0,1.35,1.35,4768,0,176.593,analises_projeto_lote/Creativemena007_BibleScholar_065beb3_1756647606/before,analises_projeto_lote/Creativemena007_BibleScholar_065beb3_1756647606/after
hongbo-miao/hongbomiao.com,111e514d1395e39713a50b18bccb35e37bc0084e,1abef37120d9c386c52e1e87d953757813974e7d,renovate[bot],3179,3179,393538,393538,0,8753,8753,0,1.893,1.893,0.0,10,10,,analises_projeto_lote/hongbo-miao_hongbomiao.com_111e514_1756647612/before,analises_projeto_lote/hongbo-miao_hongbomiao.com_111e514_1756647612/after
JE4NVRG/SoulNet,fd0afb24bed1f555572d8f1902b1dbb2c8e6d257,ef5aa14d6ea2e0304ecc2191fd06deb1eafc82f2,JE4NVRG,69,70,14125,14220,95,402,414,12,1.483,1.516,0.033,126,0,10.5,analises_projeto_lote/JE4NVRG_SoulNet_fd0afb2_1756647923/before,analises_projeto_lote/JE4NVRG_SoulNet_fd0afb2_1756647923/after
JE4NVRG/SoulNet,fe09f66adb4253f77965a78a76f2d673c4597777,4452e4f6887f77a1ed2da8b297a7afc889a106b2,JE4NVRG,68,68,14051,14052,1,386,386,0,1.49,1.49,0.0,1,0,,analises_projeto_lote/JE4NVRG_SoulNet_fe09f66_1756647930/before,analises_projeto_lote/JE4NVRG_SoulNet_fe09f66_1756647930/after
kroaton/volod-site,bd32a44d1bce9c381985d82a329b276f1cb3fd11,fbc61906a3ab712561bfe452e9570ce5df6f3c55,kroaton,15,16,1156,1218,62,7,9,2,7.0,9.0,2.0,124,6,62.0,analises_projeto_lote/kroaton_volod-site_bd32a44_1756648537/before,analises_projeto_lote/kroaton_volod-site_bd32a44_1756648537/after
Damonbodine/portfolio,76a3a8e6b10f7b1a728efac2712b187f8c104df4,c3314d71139b3595ca8adc1de046df98ece58775,Damonbodine,68,76,203372,204886,1514,408,540,132,1.855,2.0,0.145,1880,102,14.242,analises_projeto_lote/Damonbodine_portfolio_76a3a8e_1756648543/before,analises_projeto_lote/Damonbodine_portfolio_76a3a8e_1756648543/after
kulbir-ahluwalia/kulbir-ahluwalia.github.io,df3d6ad5783a4e3c426e2e000f9f84e757e6e7d2,af85f74546937425bc56095315a1d9aee043f3e9,kulbir-ahluwalia,0,0,0,0,0,0,0,0,0.0,0.0,0.0,317,0,,analises_projeto_lote/kulbir-ahluwalia_kulbir-ahluwalia.github.io_df3d6ad_1756648927/before,analises_projeto_lote/kulbir-ahluwalia_kulbir-ahluwalia.github.io_df3d6ad_1756648927/after
CERTEUS/mailledger,998047a697de447056915543ec23b47933c93047,3648486f0d035d35ae3fe7cc4f70db928abdab5b,CERTEUS,163,163,7314,7314,0,318,318,0,1.606,1.606,0.0,3,0,,analises_projeto_lote/CERTEUS_mailledger_998047a_1756648939/before,analises_projeto_lote/CERTEUS_mailledger_998047a_1756648939/after
CERTEUS/mailledger,59e78b2135542a95ecfe1d3da29d39876c454ec1,e94ce9d48f20d56b36d03385e3c9083de03040c1,CERTEUS,163,163,7314,7314,0,318,318,0,1.606,1.606,0.0,7,0,,analises_projeto_lote/CERTEUS_mailledger_59e78b2_1756648948/before,analises_projeto_lote/CERTEUS_mailledger_59e78b2_1756648948/after
CERTEUS/mailledger,e94ce9d48f20d56b36d03385e3c9083de03040c1,e3d7f613a8edb237a3d8e4e8e8be1e5894daa723,CERTEUS,163,163,7314,7314,0,318,318,0,1.606,1.606,0.0,2,0,,analises_projeto_lote/CERTEUS_mailledger_e94ce9d_1756648955/before,analises_projeto_lote/CERTEUS_mailledger_e94ce9d_1756648955/after
CERTEUS/mailledger,e3d7f613a8edb237a3d8e4e8e8be1e5894daa723,ac8121fb35619878983fe06541f4d6f621a917d4,CERTEUS,163,163,7314,7314,0,318,318,0,1.606,1.606,0.0,1,0,,analises_projeto_lote/CERTEUS_mailledger_e3d7f61_1756648962/before,analises_projeto_lote/CERTEUS_mailledger_e3d7f61_1756648962/after
CERTEUS/mailledger,ac8121fb35619878983fe06541f4d6f621a917d4,e65fb299903b38fbe91acbe54561fa7448ff8ac2,CERTEUS,163,163,7318,7314,-4,318,318,0,1.606,1.606,0.0,2,7,,analises_projeto_lote/CERTEUS_mailledger_ac8121f_1756648970/before,analises_projeto_lote/CERTEUS_mailledger_ac8121f_1756648970/after
CERTEUS/mailledger,e65fb299903b38fbe91acbe54561fa7448ff8ac2,56045caace6fce36f7d57d607ea500ffca3a8cc0,CERTEUS,163,163,7319,7318,-1,318,318,0,1.606,1.606,0.0,1,3,,analises_projeto_lote/CERTEUS_mailledger_e65fb29_1756648977/before,analises_projeto_lote/CERTEUS_mailledger_e65fb29_1756648977/after
CERTEUS/mailledger,56045caace6fce36f7d57d607ea500ffca3a8cc0,fd075d55b22d6387a007ec8f4ec4504e84961ddd,CERTEUS,163,163,7289,7319,30,316,318,2,1.604,1.606,0.002,55,13,27.5,analises_projeto_lote/CERTEUS_mailledger_56045ca_1756648985/before,analises_projeto_lote/CERTEUS_mailledger_56045ca_1756648985/after
CERTEUS/mailledger,fd075d55b22d6387a007ec8f4ec4504e84961ddd,a8c5c585bf710fd7d36edc4144c961d2d257a653,CERTEUS,162,163,7251,7289,38,309,316,7,1.626,1.604,-0.022,63,13,9.0,analises_projeto_lote/CERTEUS_mailledger_fd075d5_1756648992/before,analises_projeto_lote/CERTEUS_mailledger_fd075d5_1756648992/after
CERTEUS/mailledger,a8c5c585bf710fd7d36edc4144c961d2d257a653,194bde874523d83c77c6de03f9f1c74160de210d,CERTEUS,161,162,7161,7251,90,290,309,19,1.648,1.626,-0.022,130,13,6.842,analises_projeto_lote/CERTEUS_mailledger_a8c5c58_1756649000/before,analises_projeto_lote/CERTEUS_mailledger_a8c5c58_1756649000/after
CERTEUS/mailledger,194bde874523d83c77c6de03f9f1c74160de210d,f44d86d5540932ba198ad863016ff6035b7dd898,CERTEUS,160,161,7135,7161,26,282,290,8,1.63,1.648,0.018,38,1,4.75,analises_projeto_lote/CERTEUS_mailledger_194bde8_1756649007/before,analises_projeto_lote/CERTEUS_mailledger_194bde8_1756649007/after
CERTEUS/mailledger,f44d86d5540932ba198ad863016ff6035b7dd898,66ebc58f01d827608a92f222f379ba8f2ec2b3e6,CERTEUS,159,160,7118,7135,17,279,282,3,1.632,1.63,-0.002,25,4,8.333,analises_projeto_lote/CERTEUS_mailledger_f44d86d_1756649015/before,analises_projeto_lote/CERTEUS_mailledger_f44d86d_1756649015/after
little151/StreakMind,21be535731fbc72eb28283123e6b9d45e20d7971,7958d190714ddf78d40d778fe1d76532cc9d4428,divyanshgautam3,84,90,15490,15397,-93,525,603,78,1.415,1.446,0.031,1940,1451,24.872,analises_projeto_lote/little151_StreakMind_21be535_1756649022/before,analises_projeto_lote/little151_StreakMind_21be535_1756649022/after
lildivyansh/StreakMind,21be535731fbc72eb28283123e6b9d45e20d7971,7958d190714ddf78d40d778fe1d76532cc9d4428,divyanshgautam3,84,90,15490,15397,-93,525,603,78,1.415,1.446,0.031,1940,1451,24.872,analises_projeto_lote/lildivyansh_StreakMind_21be535_1756649029/before,analises_projeto_lote/lildivyansh_StreakMind_21be535_1756649029/after
tetraprod/AI,8321530aebe81c9f6be21767e59f785a7f5031da,c133f75e57b696fdb2a664b8e4d2da32177a5969,tetraprod,134,135,33694,33747,53,897,902,5,2.126,2.127,0.001,85,0,17.0,analises_projeto_lote/tetraprod_AI_8321530_1756649037/before,analises_projeto_lote/tetraprod_AI_8321530_1756649037/after
CERTEUS/mailledger,66ebc58f01d827608a92f222f379ba8f2ec2b3e6,ac127ddf03569c725d045c71b17a0c71ce236c0e,CERTEUS,159,159,7118,7118,0,279,279,0,1.632,1.632,0.0,1,1,,analises_projeto_lote/CERTEUS_mailledger_66ebc58_1756649166/before,analises_projeto_lote/CERTEUS_mailledger_66ebc58_1756649166/after
CERTEUS/mailledger,ac127ddf03569c725d045c71b17a0c71ce236c0e,ac6202c4d4cbd434b2d266baa32734463f233494,CERTEUS,159,159,7104,7118,14,276,279,3,1.624,1.632,0.008,23,4,7.667,analises_projeto_lote/CERTEUS_mailledger_ac127dd_1756649173/before,analises_projeto_lote/CERTEUS_mailledger_ac127dd_1756649173/after
CERTEUS/mailledger,ac6202c4d4cbd434b2d266baa32734463f233494,a8e81d908684e166d5c98a5729b3318d361e8dcd,CERTEUS,159,159,7103,7104,1,276,276,0,1.624,1.624,0.0,9,7,,analises_projeto_lote/CERTEUS_mailledger_ac6202c_1756649180/before,analises_projeto_lote/CERTEUS_mailledger_ac6202c_1756649180/after
renkosteenbeek/church-chat-symfony,96f2bd01fd214b1b038f420e7adb541449ab632e,ce266b4f3376988775a6037ce68bbe88d735b92d,Renko Steenbeek,37,60,1767,5253,3486,60,627,567,1.429,2.508,1.079,4205,13,7.416,analises_projeto_lote/renkosteenbeek_church-chat-symfony_96f2bd0_1756649187/before,analises_projeto_lote/renkosteenbeek_church-chat-symfony_96f2bd0_1756649187/after
CERTEUS/mailledger,a8e81d908684e166d5c98a5729b3318d361e8dcd,d5f9ab3eb2a5e6e596969b6286c5d42065881846,CERTEUS,159,159,7052,7103,51,269,276,7,1.592,1.624,0.032,61,6,8.714,analises_projeto_lote/CERTEUS_mailledger_a8e81d9_1756649193/before,analises_projeto_lote/CERTEUS_mailledger_a8e81d9_1756649193/after
CERTEUS/mailledger,d5f9ab3eb2a5e6e596969b6286c5d42065881846,1908a1ed88f0f95d89ceb950942c4c76a44064a0,CERTEUS,159,159,7045,7052,7,267,269,2,1.589,1.592,0.003,17,5,8.5,analises_projeto_lote/CERTEUS_mailledger_d5f9ab3_1756649200/before,analises_projeto_lote/CERTEUS_mailledger_d5f9ab3_1756649200/after
CERTEUS/mailledger,1908a1ed88f0f95d89ceb950942c4c76a44064a0,4ca06b2fd195ce171f207697943d2818ace435b5,CERTEUS,158,159,7019,7045,26,263,267,4,1.604,1.589,-0.015,38,3,9.5,analises_projeto_lote/CERTEUS_mailledger_1908a1e_1756649207/before,analises_projeto_lote/CERTEUS_mailledger_1908a1e_1756649207/after
CERTEUS/mailledger,4ca06b2fd195ce171f207697943d2818ace435b5,efd65f4b6bb6b89a3bd67ac7c76dba6597b8b816,CERTEUS,158,158,7019,7019,0,263,263,0,1.604,1.604,0.0,8,8,,analises_projeto_lote/CERTEUS_mailledger_4ca06b2_1756649215/before,analises_projeto_lote/CERTEUS_mailledger_4ca06b2_1756649215/after
CERTEUS/mailledger,efd65f4b6bb6b89a3bd67ac7c76dba6597b8b816,b258c0254c5edb0297aef69981236569178851ce,CERTEUS,157,158,6969,7019,50,260,263,3,1.615,1.604,-0.011,65,1,21.667,analises_projeto_lote/CERTEUS_mailledger_efd65f4_1756649222/before,analises_projeto_lote/CERTEUS_mailledger_efd65f4_1756649222/after
CERTEUS/mailledger,b258c0254c5edb0297aef69981236569178851ce,65426532eed1c3ec8558fe368ec9b655b6b34021,CERTEUS,157,157,6983,6969,-14,264,260,-4,1.62,1.615,-0.005,1,22,0.25,analises_projeto_lote/CERTEUS_mailledger_b258c02_1756649229/before,analises_projeto_lote/CERTEUS_mailledger_b258c02_1756649229/after
CERTEUS/mailledger,65426532eed1c3ec8558fe368ec9b655b6b34021,1b0a1a689cf47c4c825b9e6d779c8336fbf4435c,CERTEUS,157,157,6987,6983,-4,264,264,0,1.62,1.62,0.0,0,4,,analises_projeto_lote/CERTEUS_mailledger_6542653_1756649236/before,analises_projeto_lote/CERTEUS_mailledger_6542653_1756649236/after
CERTEUS/mailledger,1b0a1a689cf47c4c825b9e6d779c8336fbf4435c,493f38673acc075a0e53354065e0df3030fe0b0e,CERTEUS,157,157,6988,6987,-1,264,264,0,1.62,1.62,0.0,1,1,,analises_projeto_lote/CERTEUS_mailledger_1b0a1a6_1756649254/before,analises_projeto_lote/CERTEUS_mailledger_1b0a1a6_1756649254/after
CERTEUS/mailledger,493f38673acc075a0e53354065e0df3030fe0b0e,ae6745a81f79866b7eb1b497fe13887159f18882,CERTEUS,157,157,6995,6988,-7,265,264,-1,1.616,1.62,0.004,9,17,9.0,analises_projeto_lote/CERTEUS_mailledger_493f386_1756649260/before,analises_projeto_lote/CERTEUS_mailledger_493f386_1756649260/after
CERTEUS/mailledger,ae6745a81f79866b7eb1b497fe13887159f18882,81cfae41391e2301188e1213db84049ba3b90f1e,CERTEUS,156,157,6946,6995,49,256,265,9,1.652,1.616,-0.036,74,3,8.222,analises_projeto_lote/CERTEUS_mailledger_ae6745a_1756649267/before,analises_projeto_lote/CERTEUS_mailledger_ae6745a_1756649267/after
CERTEUS/mailledger,81cfae41391e2301188e1213db84049ba3b90f1e,9a9fa2b4c1b4534df3afc8ba102d1287379ce169,CERTEUS,156,156,6932,6946,14,252,256,4,1.647,1.652,0.005,22,1,5.5,analises_projeto_lote/CERTEUS_mailledger_81cfae4_1756649274/before,analises_projeto_lote/CERTEUS_mailledger_81cfae4_1756649274/after
CERTEUS/mailledger,9a9fa2b4c1b4534df3afc8ba102d1287379ce169,01273e9acbc2bae49c928e922efb32300715d79f,CERTEUS,156,156,6932,6932,0,252,252,0,1.647,1.647,0.0,3,3,,analises_projeto_lote/CERTEUS_mailledger_9a9fa2b_1756649281/before,analises_projeto_lote/CERTEUS_mailledger_9a9fa2b_1756649281/after
CERTEUS/mailledger,01273e9acbc2bae49c928e922efb32300715d79f,5cef82b6a93e329bfd762dccd763394133a86e6a,CERTEUS,156,156,6924,6932,8,250,252,2,1.645,1.647,0.002,20,34,10.0,analises_projeto_lote/CERTEUS_mailledger_01273e9_1756649288/before,analises_projeto_lote/CERTEUS_mailledger_01273e9_1756649288/after
CERTEUS/mailledger,5cef82b6a93e329bfd762dccd763394133a86e6a,67ae6d127e8fcde535c75a4329b4d0c22548963d,CERTEUS,156,156,6916,6924,8,249,250,1,1.649,1.645,-0.004,19,8,19.0,analises_projeto_lote/CERTEUS_mailledger_5cef82b_1756649295/before,analises_projeto_lote/CERTEUS_mailledger_5cef82b_1756649295/after
CERTEUS/mailledger,67ae6d127e8fcde535c75a4329b4d0c22548963d,05239fb8a2c1260fd479049c9f0fbb14700076cb,CERTEUS,156,156,6916,6916,0,249,249,0,1.649,1.649,0.0,1,1,,analises_projeto_lote/CERTEUS_mailledger_67ae6d1_1756649302/before,analises_projeto_lote/CERTEUS_mailledger_67ae6d1_1756649302/after
roshikdatla/Amberwood-Football-League,b1ab7270092ca65f005d363b0fbdfbfb799f0cf9,b12688c9333cc40aa1e57feb17f15e2c05aa8ace,Roshik Datla,78,78,91718,91718,0,705,705,0,2.776,2.776,0.0,25,25,,analises_projeto_lote/roshikdatla_Amberwood-Football-League_b1ab727_1756649308/before,analises_projeto_lote/roshikdatla_Amberwood-Football-League_b1ab727_1756649308/after
ewdlop/ewdlop,f4e118c35ae1bcd2e806e68f60a8d32d0a1ad204,25303a06246f7db7559e86c900b31e7e2ca6758e,ewdlop,26,26,18301,18301,0,0,0,0,0.0,0.0,0.0,3,2,,analises_projeto_lote/ewdlop_ewdlop_f4e118c_1756649883/before,analises_projeto_lote/ewdlop_ewdlop_f4e118c_1756649883/after
roshikdatla/Amberwood-Football-League,b12688c9333cc40aa1e57feb17f15e2c05aa8ace,98ce30c2744b9bcee3dce3e2b5f4b36d06e98fa4,Roshik Datla,78,78,91673,91718,45,688,705,17,2.774,2.776,0.002,58,4,3.412,analises_projeto_lote/roshikdatla_Amberwood-Football-League_b12688c_1756649894/before,analises_projeto_lote/roshikdatla_Amberwood-Football-League_b12688c_1756649894/after
cryptogrammer/gptcomments,81770a873cbf22b70c2521d4ad4aa7bb89857473,22db7d072c705a2c8d01b51caaa615acb198922c,cryptogrammer,1,34,0,3252,3252,0,19,19,0.0,1.267,1.267,1272,0,66.947,analises_projeto_lote/cryptogrammer_gptcomments_81770a8_1756650469/before,analises_projeto_lote/cryptogrammer_gptcomments_81770a8_1756650469/after
CERTEUS/mailledger,05239fb8a2c1260fd479049c9f0fbb14700076cb,17fea89c428a839cdcf0f7a78abd1aae8f46e41b,CERTEUS,141,156,6610,6916,306,249,249,0,1.649,1.649,0.0,319,0,,analises_projeto_lote/CERTEUS_mailledger_05239fb_1756650475/before,analises_projeto_lote/CERTEUS_mailledger_05239fb_1756650475/after
Ismailhoucheimi/market-analysis,a2e6697932a617363fbba0efa3b6da14a4bde411,dd86073107f39ea9ca99636c09620bb26a4498df,Ismailhoucheimi,95,95,163242,163291,49,806,806,0,3.647,3.647,0.0,776,734,,analises_projeto_lote/Ismailhoucheimi_market-analysis_a2e6697_1756650481/before,analises_projeto_lote/Ismailhoucheimi_market-analysis_a2e6697_1756650481/after
CERTEUS/mailledger,17fea89c428a839cdcf0f7a78abd1aae8f46e41b,fe13384215be0aa8084619a9ad9b9353c4a85a18,CERTEUS,141,141,6610,6610,0,249,249,0,1.649,1.649,0.0,8,7,,analises_projeto_lote/CERTEUS_mailledger_17fea89_1756650621/before,analises_projeto_lote/CERTEUS_mailledger_17fea89_1756650621/after
CERTEUS/mailledger,fe13384215be0aa8084619a9ad9b9353c4a85a18,3055a3229b7e7c89e2336d2162813a97fbc7c049,CERTEUS,141,141,6609,6610,1,249,249,0,1.649,1.649,0.0,12,15,,analises_projeto_lote/CERTEUS_mailledger_fe13384_1756650628/before,analises_projeto_lote/CERTEUS_mailledger_fe13384_1756650628/after
CERTEUS/mailledger,3055a3229b7e7c89e2336d2162813a97fbc7c049,33b4cc4814e7626bf5b08a17cf34c9c075a38e9f,CERTEUS,141,141,6596,6609,13,248,249,1,1.653,1.649,-0.004,21,3,21.0,analises_projeto_lote/CERTEUS_mailledger_3055a32_1756650635/before,analises_projeto_lote/CERTEUS_mailledger_3055a32_1756650635/after
g-u-m-t-r-e-e/CDs,92c08c8c6808eeb77a58732ce742703f137c73e4,22c95fc737055f3ac685a04092b0e51700f61c98,g-u-m-t-r-e-e,14,20,1565,2389,824,0,0,0,0.0,0.0,0.0,2273,1381,,analises_projeto_lote/g-u-m-t-r-e-e_CDs_92c08c8_1756650643/before,analises_projeto_lote/g-u-m-t-r-e-e_CDs_92c08c8_1756650643/after
ewdlop/ewdlop,7b13db779904659e87b1bb527c18be1b2fe413a1,6e8e40f6b7b37a171cb2281facae5aa8d1feb366,ewdlop,26,26,18277,18291,14,0,0,0,0.0,0.0,0.0,14,0,,analises_projeto_lote/ewdlop_ewdlop_7b13db7_1756650649/before,analises_projeto_lote/ewdlop_ewdlop_7b13db7_1756650649/after
CERTEUS/mailledger,33b4cc4814e7626bf5b08a17cf34c9c075a38e9f,6b0ede3bdd0077c51e8744c60f836e94b6c393ea,CERTEUS,137,141,6503,6596,93,248,248,0,1.653,1.653,0.0,105,0,,analises_projeto_lote/CERTEUS_mailledger_33b4cc4_1756650660/before,analises_projeto_lote/CERTEUS_mailledger_33b4cc4_1756650660/after
CERTEUS/mailledger,6b0ede3bdd0077c51e8744c60f836e94b6c393ea,f5d81af5ac556b4efa4c808ba5f1918815f5c015,CERTEUS,137,137,6503,6503,0,248,248,0,1.653,1.653,0.0,10,10,,analises_projeto_lote/CERTEUS_mailledger_6b0ede3_1756650667/before,analises_projeto_lote/CERTEUS_mailledger_6b0ede3_1756650667/after
CERTEUS/mailledger,f5d81af5ac556b4efa4c808ba5f1918815f5c015,4987a41a6a58ea83dc5b1ad8b3dcc716897ef00b,CERTEUS,137,137,6506,6503,-3,248,248,0,1.653,1.653,0.0,4,8,,analises_projeto_lote/CERTEUS_mailledger_f5d81af_1756650674/before,analises_projeto_lote/CERTEUS_mailledger_f5d81af_1756650674/after
kevinveenbirkenbach/infinito-nexus,97f4045c6855ab7d61d20e2278bd07148a8e5ca3,c182ecf516030e019cb06174da75438b98558d47,kevinveenbirkenbach,1858,1858,56030,56050,20,3463,3463,0,3.343,3.343,0.0,22,2,,analises_projeto_lote/kevinveenbirkenbach_infinito-nexus_97f4045_1756650680/before,analises_projeto_lote/kevinveenbirkenbach_infinito-nexus_97f4045_1756650680/after
adamblumoff/student-success-prediction,ea20328bf83568fdf8b7f65fb636004dbc9637c1,aea948e7994490fa1b6df2970da246087ac4bdd3,Adam Blumoff,199,198,121419,121381,-38,5167,5163,-4,2.765,2.764,-0.001,0,58,0.0,analises_projeto_lote/adamblumoff_student-success-prediction_ea20328_1756650693/before,analises_projeto_lote/adamblumoff_student-success-prediction_ea20328_1756650693/after
datablogin/nav-insights,eab91b81088825ebb6ec7232d5057e1f33e1a735,7e240852d33b6bb525a768475186819e1757db4d,datablogin,85,87,9050,9172,122,742,754,12,2.887,2.856,-0.031,145,5,12.083,analises_projeto_lote/datablogin_nav-insights_eab91b8_1756650736/before,analises_projeto_lote/datablogin_nav-insights_eab91b8_1756650736/after
CERTEUS/mailledger,4987a41a6a58ea83dc5b1ad8b3dcc716897ef00b,9cd2f409967915839ea98d69e2684e1a6bfe9201,CERTEUS,135,137,6479,6506,27,245,248,3,1.667,1.653,-0.014,36,0,12.0,analises_projeto_lote/CERTEUS_mailledger_4987a41_1756650743/before,analises_projeto_lote/CERTEUS_mailledger_4987a41_1756650743/after
CERTEUS/mailledger,9cd2f409967915839ea98d69e2684e1a6bfe9201,427b8c51fc7a13b7e9ebc4de6166f2564a9d5eee,CERTEUS,125,135,5971,6479,508,236,245,9,1.674,1.667,-0.007,568,0,63.111,analises_projeto_lote/CERTEUS_mailledger_9cd2f40_1756650750/before,analises_projeto_lote/CERTEUS_mailledger_9cd2f40_1756650750/after
CERTEUS/mailledger,427b8c51fc7a13b7e9ebc4de6166f2564a9d5eee,4117bcb1152fa83579475969e6d571010e19c55c,CERTEUS,123,125,5817,5971,154,214,236,22,1.672,1.674,0.002,232,2,10.545,analises_projeto_lote/CERTEUS_mailledger_427b8c5_1756650757/before,analises_projeto_lote/CERTEUS_mailledger_427b8c5_1756650757/after
CERTEUS/mailledger,4117bcb1152fa83579475969e6d571010e19c55c,76ea5892b7b28cb83574481462fc9e33e12fd6fd,CERTEUS,120,123,5620,5817,197,212,214,2,1.669,1.672,0.003,272,8,136.0,analises_projeto_lote/CERTEUS_mailledger_4117bcb_1756650764/before,analises_projeto_lote/CERTEUS_mailledger_4117bcb_1756650764/after
CERTEUS/mailledger,76ea5892b7b28cb83574481462fc9e33e12fd6fd,28b71ae7df8d0be119ae0f2196124d37294f24c8,CERTEUS,116,120,5451,5620,169,193,212,19,1.678,1.669,-0.009,238,13,12.526,analises_projeto_lote/CERTEUS_mailledger_76ea589_1756650771/before,analises_projeto_lote/CERTEUS_mailledger_76ea589_1756650771/after
tommasoderossi7/nanda_mats,8158d4cec0917091f1778549f2603cfaa941744d,90d7a5308cbbc7da0b4d2b9788b1cd1ef22e60a2,tommasoderossi7,36,40,351487,352082,595,167,246,79,3.553,4.473,0.92,890,154,11.266,analises_projeto_lote/tommasoderossi7_nanda_mats_8158d4c_1756650778/before,analises_projeto_lote/tommasoderossi7_nanda_mats_8158d4c_1756650778/after
CERTEUS/mailledger,28b71ae7df8d0be119ae0f2196124d37294f24c8,16468c5d01b49865969bde115bdb8dcf397b1abc,CERTEUS,116,116,5413,5451,38,188,193,5,1.694,1.678,-0.016,94,21,18.8,analises_projeto_lote/CERTEUS_mailledger_28b71ae_1756651067/before,analises_projeto_lote/CERTEUS_mailledger_28b71ae_1756651067/after
CERTEUS/mailledger,16468c5d01b49865969bde115bdb8dcf397b1abc,eaa75e1213cdac2248111f168d6e196990d5655f,CERTEUS,112,116,5200,5413,213,164,188,24,1.624,1.694,0.07,292,12,12.167,analises_projeto_lote/CERTEUS_mailledger_16468c5_1756651074/before,analises_projeto_lote/CERTEUS_mailledger_16468c5_1756651074/after
CERTEUS/mailledger,eaa75e1213cdac2248111f168d6e196990d5655f,15f8c91841da12d7acfa928f88a676c4aff2420a,CERTEUS,112,112,5196,5200,4,164,164,0,1.624,1.624,0.0,4,0,,analises_projeto_lote/CERTEUS_mailledger_eaa75e1_1756651081/before,analises_projeto_lote/CERTEUS_mailledger_eaa75e1_1756651081/after
CERTEUS/mailledger,15f8c91841da12d7acfa928f88a676c4aff2420a,f6bb93247c9abd411f41df0ad5fbc4ce1efe5672,CERTEUS,111,112,5179,5196,17,162,164,2,1.636,1.624,-0.012,25,0,12.5,analises_projeto_lote/CERTEUS_mailledger_15f8c91_1756651087/before,analises_projeto_lote/CERTEUS_mailledger_15f8c91_1756651087/after
CERTEUS/mailledger,f6bb93247c9abd411f41df0ad5fbc4ce1efe5672,ec213408a46276522c91188de8bbbf3d7e63b6bb,CERTEUS,111,111,5179,5179,0,162,162,0,1.636,1.636,0.0,0,2,,analises_projeto_lote/CERTEUS_mailledger_f6bb932_1756651094/before,analises_projeto_lote/CERTEUS_mailledger_f6bb932_1756651094/after
CERTEUS/mailledger,ec213408a46276522c91188de8bbbf3d7e63b6bb,8ee2d020657f3b24b80f4313e0e0d0a816af4467,CERTEUS,111,111,5179,5179,0,162,162,0,1.636,1.636,0.0,28,0,,analises_projeto_lote/CERTEUS_mailledger_ec21340_1756651101/before,analises_projeto_lote/CERTEUS_mailledger_ec21340_1756651101/after
kevinveenbirkenbach/infinito-nexus,c182ecf516030e019cb06174da75438b98558d47,ce033c370abfaded495c38f016d3b278bba2e301,kevinveenbirkenbach,1853,1858,55728,56030,302,3390,3463,73,3.301,3.343,0.042,543,146,7.438,analises_projeto_lote/kevinveenbirkenbach_infinito-nexus_c182ecf_1756651107/before,analises_projeto_lote/kevinveenbirkenbach_infinito-nexus_c182ecf_1756651107/after
CERTEUS/mailledger,8ee2d020657f3b24b80f4313e0e0d0a816af4467,7340c6e233b4a7d85af8ac7c207776ccc4a4615b,CERTEUS,111,111,5179,5179,0,162,162,0,1.636,1.636,0.0,83,0,,analises_projeto_lote/CERTEUS_mailledger_8ee2d02_1756651120/before,analises_projeto_lote/CERTEUS_mailledger_8ee2d02_1756651120/after
CERTEUS/mailledger,7340c6e233b4a7d85af8ac7c207776ccc4a4615b,f3fa3bfb393e210ebdefaf780845834efdee09a3,CERTEUS,111,111,5149,5179,30,159,162,3,1.639,1.636,-0.003,57,1,19.0,analises_projeto_lote/CERTEUS_mailledger_7340c6e_1756651127/before,analises_projeto_lote/CERTEUS_mailledger_7340c6e_1756651127/after
CERTEUS/mailledger,f3fa3bfb393e210ebdefaf780845834efdee09a3,8875dfdf78e63851e7128c607b28d1078cf45add,CERTEUS,111,111,5138,5149,11,156,159,3,1.642,1.639,-0.003,24,8,8.0,analises_projeto_lote/CERTEUS_mailledger_f3fa3bf_1756651133/before,analises_projeto_lote/CERTEUS_mailledger_f3fa3bf_1756651133/after
CERTEUS/mailledger,8875dfdf78e63851e7128c607b28d1078cf45add,97147b1f1a0c31b6c8fb311bbabb18e6820e424b,CERTEUS,110,111,4951,5138,187,156,156,0,1.642,1.642,0.0,190,0,,analises_projeto_lote/CERTEUS_mailledger_8875dfd_1756651140/before,analises_projeto_lote/CERTEUS_mailledger_8875dfd_1756651140/after
CERTEUS/mailledger,97147b1f1a0c31b6c8fb311bbabb18e6820e424b,bafdbb4789be11e4b6896ce29740a74b572b13ae,CERTEUS,107,110,4887,4951,64,156,156,0,1.642,1.642,0.0,112,0,,analises_projeto_lote/CERTEUS_mailledger_97147b1_1756651158/before,analises_projeto_lote/CERTEUS_mailledger_97147b1_1756651158/after
CERTEUS/mailledger,bafdbb4789be11e4b6896ce29740a74b572b13ae,afdbdf87b2a0ec9189032354af8b284b524f15fc,CERTEUS,101,107,4768,4887,119,137,156,19,1.631,1.642,0.011,145,0,7.632,analises_projeto_lote/CERTEUS_mailledger_bafdbb4_1756651164/before,analises_projeto_lote/CERTEUS_mailledger_bafdbb4_1756651164/after
CERTEUS/mailledger,afdbdf87b2a0ec9189032354af8b284b524f15fc,900bfc18b8c05e5121dd88d2f0878c6c3e40d5a6,CERTEUS,99,101,4753,4768,15,137,137,0,1.631,1.631,0.0,32,2,,analises_projeto_lote/CERTEUS_mailledger_afdbdf8_1756651171/before,analises_projeto_lote/CERTEUS_mailledger_afdbdf8_1756651171/after
CERTEUS/mailledger,900bfc18b8c05e5121dd88d2f0878c6c3e40d5a6,603cfa42cd0d416715fb1662e1e53b4fd1a21c7c,CERTEUS,99,99,4753,4753,0,137,137,0,1.631,1.631,0.0,1,1,,analises_projeto_lote/CERTEUS_mailledger_900bfc1_1756651178/before,analises_projeto_lote/CERTEUS_mailledger_900bfc1_1756651178/after
CERTEUS/mailledger,603cfa42cd0d416715fb1662e1e53b4fd1a21c7c,85b9a6c86dbb628552cdeef4772776aae3629057,CERTEUS,99,99,4747,4753,6,137,137,0,1.651,1.631,-0.02,14,6,,analises_projeto_lote/CERTEUS_mailledger_603cfa4_1756651185/before,analises_projeto_lote/CERTEUS_mailledger_603cfa4_1756651185/after
CERTEUS/mailledger,85b9a6c86dbb628552cdeef4772776aae3629057,6273073896a62b7cfae9e5f2499457312ad54d74,CERTEUS,99,99,4739,4747,8,136,137,1,1.639,1.651,0.012,19,7,19.0,analises_projeto_lote/CERTEUS_mailledger_85b9a6c_1756651191/before,analises_projeto_lote/CERTEUS_mailledger_85b9a6c_1756651191/after
CERTEUS/mailledger,6273073896a62b7cfae9e5f2499457312ad54d74,8eb0b6c31a084a173ac4ba5bb350c2b9417e6f2d,CERTEUS,98,99,4692,4739,47,133,136,3,1.663,1.639,-0.024,69,15,23.0,analises_projeto_lote/CERTEUS_mailledger_6273073_1756651198/before,analises_projeto_lote/CERTEUS_mailledger_6273073_1756651198/after
CERTEUS/mailledger,8eb0b6c31a084a173ac4ba5bb350c2b9417e6f2d,baace5acf8270b97577dd6bc36b5c1399a95e4c6,CERTEUS,98,98,4669,4692,23,129,133,4,1.654,1.663,0.009,93,10,23.25,analises_projeto_lote/CERTEUS_mailledger_8eb0b6c_1756651205/before,analises_projeto_lote/CERTEUS_mailledger_8eb0b6c_1756651205/after
CERTEUS/mailledger,baace5acf8270b97577dd6bc36b5c1399a95e4c6,a574cfb07c8e5cd734b09de3ebe4434ee340f494,CERTEUS,98,98,4653,4669,16,128,129,1,1.662,1.654,-0.008,20,1,20.0,analises_projeto_lote/CERTEUS_mailledger_baace5a_1756651211/before,analises_projeto_lote/CERTEUS_mailledger_baace5a_1756651211/after
CERTEUS/mailledger,a574cfb07c8e5cd734b09de3ebe4434ee340f494,b33b8c7f500c23df65d7943843e9b91e55cee00a,CERTEUS,98,98,4634,4653,19,128,128,0,1.662,1.662,0.0,31,10,,analises_projeto_lote/CERTEUS_mailledger_a574cfb_1756651218/before,analises_projeto_lote/CERTEUS_mailledger_a574cfb_1756651218/after
mithorizon7/FoundBootstrapSeparated,e3a41139c69e9909ccad62039a46a37fb82acebc,c4868e89b6d5948bb400a7a43b032134585f1118,mithorizon7,339,339,85197,85192,-5,1324,1324,0,1.498,1.498,0.0,8,13,,analises_projeto_lote/mithorizon7_FoundBootstrapSeparated_e3a4113_1756651225/before,analises_projeto_lote/mithorizon7_FoundBootstrapSeparated_e3a4113_1756651225/after
CERTEUS/mailledger,b33b8c7f500c23df65d7943843e9b91e55cee00a,ea537c3bbbd7ff678fb05e3ad651aa0f6fdcaf38,CERTEUS,95,98,4551,4634,83,128,128,0,1.662,1.662,0.0,112,0,,analises_projeto_lote/CERTEUS_mailledger_b33b8c7_1756651256/before,analises_projeto_lote/CERTEUS_mailledger_b33b8c7_1756651256/after
CERTEUS/mailledger,ea537c3bbbd7ff678fb05e3ad651aa0f6fdcaf38,b75c943fb8ef18b3903dac6b4054f06ff1102dbe,CERTEUS,96,95,4555,4551,-4,128,128,0,1.662,1.662,0.0,3,4,,analises_projeto_lote/CERTEUS_mailledger_ea537c3_1756651262/before,analises_projeto_lote/CERTEUS_mailledger_ea537c3_1756651262/after
CERTEUS/mailledger,b75c943fb8ef18b3903dac6b4054f06ff1102dbe,69568c4c42fe9138293ce772dc2b830f9bb2c84e,CERTEUS,96,96,4555,4555,0,128,128,0,1.662,1.662,0.0,47,0,,analises_projeto_lote/CERTEUS_mailledger_b75c943_1756651268/before,analises_projeto_lote/CERTEUS_mailledger_b75c943_1756651268/after
CERTEUS/mailledger,69568c4c42fe9138293ce772dc2b830f9bb2c84e,7a8d7e64263e3acfca50f4b235bec090382282b9,CERTEUS,93,96,4505,4555,50,126,128,2,1.68,1.662,-0.018,118,0,59.0,analises_projeto_lote/CERTEUS_mailledger_69568c4_1756651275/before,analises_projeto_lote/CERTEUS_mailledger_69568c4_1756651275/after
CERTEUS/mailledger,7a8d7e64263e3acfca50f4b235bec090382282b9,430c700884621d8d8532751b3f66f3369e97ed68,CERTEUS,92,93,4502,4505,3,126,126,0,1.68,1.68,0.0,30,0,,analises_projeto_lote/CERTEUS_mailledger_7a8d7e6_1756651281/before,analises_projeto_lote/CERTEUS_mailledger_7a8d7e6_1756651281/after
KNOCKYONG/sona_app,388e2e7091958ad9122512f8747063296feb9be5,e0485d98641b61dfe5c4a63da86675e56f9d99ad,KNOCKYONG,602,602,219335,219381,46,12793,12799,6,5.555,5.562,0.007,144,89,24.0,analises_projeto_lote/KNOCKYONG_sona_app_388e2e7_1756651287/before,analises_projeto_lote/KNOCKYONG_sona_app_388e2e7_1756651287/after
sardagsoftware/ailydian-video,aaf963cfec62f0ba00d0977e0cd57df433c53e70,b1e24199aff11777cad012c3f6fe49c2005c0a83,devin-ai-integration[bot],323,324,36219,36230,11,2626,2637,11,1.663,1.666,0.003,154,133,14.0,analises_projeto_lote/sardagsoftware_ailydian-video_aaf963c_1756651335/before,analises_projeto_lote/sardagsoftware_ailydian-video_aaf963c_1756651335/after
sardagsoftware/ailydian-video,4b2fd70585d452a29addb21574584f2b22444aa8,a7dd4263ca280b4f06a06402afbaa0a862737452,devin-ai-integration[bot],242,282,27082,31385,4303,1928,2206,278,1.799,1.789,-0.01,8916,0,32.072,analises_projeto_lote/sardagsoftware_ailydian-video_4b2fd70_1756651344/before,analises_projeto_lote/sardagsoftware_ailydian-video_4b2fd70_1756651344/after
sardagsoftware/ailydian-video,a7dd4263ca280b4f06a06402afbaa0a862737452,9bb8d0e5c95458ad6223e1e21364cc1b376b64c6,devin-ai-integration[bot],242,242,25848,27082,1234,1928,1928,0,1.799,1.799,0.0,1829,125,,analises_projeto_lote/sardagsoftware_ailydian-video_a7dd426_1756651352/before,analises_projeto_lote/sardagsoftware_ailydian-video_a7dd426_1756651352/after
sardagsoftware/ailydian-video,9bb8d0e5c95458ad6223e1e21364cc1b376b64c6,96fb1238b4ed93c82836870ec3d2e87849ed20d6,devin-ai-integration[bot],237,242,25232,25848,616,1855,1928,73,1.804,1.799,-0.005,1094,17,14.986,analises_projeto_lote/sardagsoftware_ailydian-video_9bb8d0e_1756651360/before,analises_projeto_lote/sardagsoftware_ailydian-video_9bb8d0e_1756651360/after
AyushDwivedi100/powertonengineering,0d704595c13aff8016c886b4dc93c8982b695493,c8156c1f19e253d264a5d0b6f6d4364a299d9959,baler77563,386,387,131014,131211,197,850,850,0,1.625,1.625,0.0,2,2,,analises_projeto_lote/AyushDwivedi100_powertonengineering_0d70459_1756651369/before,analises_projeto_lote/AyushDwivedi100_powertonengineering_0d70459_1756651369/after
kadragon/knue-campus-counsel,50552e33723403d8a830c19d4439f28e3572adbd,1b26fc5fb24c1a360d6303e0b21ada8b80a1f30f,knue-bot,31,34,3782,4709,927,248,339,91,1.393,1.436,0.043,1147,27,12.604,analises_projeto_lote/kadragon_knue-campus-counsel_50552e3_1756651406/before,analises_projeto_lote/kadragon_knue-campus-counsel_50552e3_1756651406/after
kevinveenbirkenbach/infinito-nexus,594d9417d19c69ca5bb7b7c8e20ee5421e1010f9,dc125e484391b491ae37862d837045ceff057cae,kevinveenbirkenbach,1844,1844,55129,55156,27,3285,3285,0,3.325,3.325,0.0,31,3,,analises_projeto_lote/kevinveenbirkenbach_infinito-nexus_594d941_1756651413/before,analises_projeto_lote/kevinveenbirkenbach_infinito-nexus_594d941_1756651413/after
brianjhang/brian-jhangs-edge,4705c51bd260e9905c7157a8c11b45774291386a,fcb2882fb4d5c99c1b9e219a09755f819918c979,Brian Jhang,29,31,9383,10296,913,20,20,0,1.538,1.538,0.0,1053,24,,analises_projeto_lote/brianjhang_brian-jhangs-edge_4705c51_1756651426/before,analises_projeto_lote/brianjhang_brian-jhangs-edge_4705c51_1756651426/after
Moshy613/moshysphotography-homepage,8559d7dea22e99e7100ea0f02c00de1dc4c3dd19,a4c17bef683d42119cc8c38d14166d0c8c998094,Moshy613,3,24,1070,3362,2292,51,163,112,1.378,1.509,0.131,2757,0,24.616,analises_projeto_lote/Moshy613_moshysphotography-homepage_8559d7d_1756651433/before,analises_projeto_lote/Moshy613_moshysphotography-homepage_8559d7d_1756651433/after
kevinveenbirkenbach/infinito-nexus,4ce681e643c08c63b0dc5742f821b52e2cb5fd37,55cf3d0d8e68c56cdc80f2bbb604d2c7cdf70aef,kevinveenbirkenbach,1842,1844,55018,55129,111,3243,3285,42,3.313,3.325,0.012,144,1,3.429,analises_projeto_lote/kevinveenbirkenbach_infinito-nexus_4ce681e_1756651439/before,analises_projeto_lote/kevinveenbirkenbach_infinito-nexus_4ce681e_1756651439/after
kevinveenbirkenbach/infinito-nexus,6d70f78989d01c3e3306874b0cefd4bf4d1d40a2,b867a5247170bfd77c0523fd789865f7b3117f5a,kevinveenbirkenbach,1841,1841,55002,55011,9,3242,3243,1,3.312,3.313,0.001,17,8,17.0,analises_projeto_lote/kevinveenbirkenbach_infinito-nexus_6d70f78_1756651452/before,analises_projeto_lote/kevinveenbirkenbach_infinito-nexus_6d70f78_1756651452/after
kevinveenbirkenbach/infinito-nexus,b867a5247170bfd77c0523fd789865f7b3117f5a,78ee3e3c645187de7a37bb548e91b410443e98b1,kevinveenbirkenbach,1839,1841,54516,55002,486,3118,3242,124,3.272,3.312,0.04,745,220,6.008,analises_projeto_lote/kevinveenbirkenbach_infinito-nexus_b867a52_1756651465/before,analises_projeto_lote/kevinveenbirkenbach_infinito-nexus_b867a52_1756651465/after
Worklytics/psoxy,8b617e68d2589c19111fe3bfe1c5d2c6980625ce,069aa308cf76f08cbd90d0b2b6cbb221ee65490f,aperez-worklytics,1274,1274,222749,222765,16,2630,2630,0,1.602,1.602,0.0,21,5,,analises_projeto_lote/Worklytics_psoxy_8b617e6_1756652078/before,analises_projeto_lote/Worklytics_psoxy_8b617e6_1756652078/after
Worklytics/psoxy,069aa308cf76f08cbd90d0b2b6cbb221ee65490f,86451d9b13e23fb0b3392898c66286f880b9fcb4,eschultink,1274,1274,222605,222749,144,2630,2630,0,1.602,1.602,0.0,235,92,,analises_projeto_lote/Worklytics_psoxy_069aa30_1756652099/before,analises_projeto_lote/Worklytics_psoxy_069aa30_1756652099/after
usagi917/council-dashboard-and-ai-chat,25ca1772d66173118a999348ee400719ce221bf2,4b866ce5da1fe7d2c53dc160759e6be44bfadc0f,usagi917,43,45,36222,36338,116,3984,3996,12,11.16,10.829,-0.331,161,0,13.417,analises_projeto_lote/usagi917_council-dashboard-and-ai-chat_25ca177_1756652122/before,analises_projeto_lote/usagi917_council-dashboard-and-ai-chat_25ca177_1756652122/after
gaiin-platform/amplify-genai-frontend,8131a4382c70566c24539e79dbde565a2b08f6cc,75ed9e75d526006e40b6bf6a61a3e763a5305ba5,karnsab,613,613,130953,131872,919,15376,15436,60,2.47,2.471,0.001,1800,422,30.0,analises_projeto_lote/gaiin-platform_amplify-genai-frontend_8131a43_1756652130/before,analises_projeto_lote/gaiin-platform_amplify-genai-frontend_8131a43_1756652130/after
alexmeckes/mcp-client-proto,d15f1d39790aab6b098c57b679377d5a155dea10,8d68826f779580f4687d685f61d077d958c269f3,alexmeckes,239,239,128194,128202,8,3235,3238,3,2.703,2.705,0.002,15,2,5.0,analises_projeto_lote/alexmeckes_mcp-client-proto_d15f1d3_1756652147/before,analises_projeto_lote/alexmeckes_mcp-client-proto_d15f1d3_1756652147/after
ebarlowjr2/blox1.2,5196ed9f70274cac0111bb11c3488275fc95213c,72390aa8d5874263e117d908dad11ff6e8459021,devin-ai-integration[bot],19,19,8007,8007,0,46,46,0,1.353,1.353,0.0,42,32,,analises_projeto_lote/ebarlowjr2_blox1.2_5196ed9_1756652163/before,analises_projeto_lote/ebarlowjr2_blox1.2_5196ed9_1756652163/after
JiaJunDeng5930/agentX,783654e218c75ca00b43081c4d6a54a66d4c742f,e91c3d6d1cc050a9ca85d3460799f22c7d0541b9,ae-openai,322,322,86925,86925,0,3950,3950,0,2.924,2.924,0.0,6,7,,analises_projeto_lote/JiaJunDeng5930_agentX_783654e_1756652170/before,analises_projeto_lote/JiaJunDeng5930_agentX_783654e_1756652170/after
openai/codex,783654e218c75ca00b43081c4d6a54a66d4c742f,e91c3d6d1cc050a9ca85d3460799f22c7d0541b9,ae-openai,322,322,86925,86925,0,3950,3950,0,2.924,2.924,0.0,6,7,,analises_projeto_lote/openai_codex_783654e_1756652188/before,analises_projeto_lote/openai_codex_783654e_1756652188/after
kevinveenbirkenbach/infinito-nexus,b90a2f6c87581c4eaabcf1502cbfdb3d5d2996d4,98e045196b5cecfd12744c1c095d91938222befb,kevinveenbirkenbach,1842,1842,54499,54503,4,3118,3118,0,3.272,3.272,0.0,12,4,,analises_projeto_lote/kevinveenbirkenbach_infinito-nexus_b90a2f6_1756652206/before,analises_projeto_lote/kevinveenbirkenbach_infinito-nexus_b90a2f6_1756652206/after
nickberens360/nickberens-astro,f2f30d095ca8f0feb783b9ded6b68f93f872a8e5,1e765a374cddf6a5329ffee95b2d7b4532d37617,nickberens360,223,223,95719,95729,10,2157,2157,0,2.809,2.809,0.0,45,32,,analises_projeto_lote/nickberens360_nickberens-astro_f2f30d0_1756654019/before,analises_projeto_lote/nickberens360_nickberens-astro_f2f30d0_1756654019/after
kevinveenbirkenbach/infinito-nexus,a10dd402b8007c9dc4494449271476e8ad3ea18b,6e538eabc8497a6a181a889470f399dbd967fa81,kevinveenbirkenbach,1842,1842,54470,54503,33,3118,3118,0,3.272,3.272,0.0,82,55,,analises_projeto_lote/kevinveenbirkenbach_infinito-nexus_a10dd40_1756654147/before,analises_projeto_lote/kevinveenbirkenbach_infinito-nexus_a10dd40_1756654147/after
kevinveenbirkenbach/infinito-nexus,6e538eabc8497a6a181a889470f399dbd967fa81,82cc24a7f54b56867cfa4351bc2806eca4745593,kevinveenbirkenbach,1842,1842,54470,54470,0,3118,3118,0,3.272,3.272,0.0,284,19,,analises_projeto_lote/kevinveenbirkenbach_infinito-nexus_6e538ea_1756654159/before,analises_projeto_lote/kevinveenbirkenbach_infinito-nexus_6e538ea_1756654159/after
SinghaAnirban005/MyGPT,09e78235adfd95768e87835e3b718d17f560f307,37881fe4a46ad700455e6231aefb77761f4d6acf,SinghaAnirban005,44,46,15966,16173,207,307,317,10,2.225,2.142,-0.083,249,33,24.9,analises_projeto_lote/SinghaAnirban005_MyGPT_09e7823_1756654172/before,analises_projeto_lote/SinghaAnirban005_MyGPT_09e7823_1756654172/after
gmkung/telegram-digester,b89df0e400dc2821309a3866281d391e2bd5d739,c06ce7edc31697867789a67df6687c788673235f,gmkung,22,47,3557,5901,2344,462,850,388,3.143,4.028,0.885,4015,679,10.348,analises_projeto_lote/gmkung_telegram-digester_b89df0e_1756654179/before,analises_projeto_lote/gmkung_telegram-digester_b89df0e_1756654179/after
The-Banksy-House/declaration_001,e98e6937dd86503e6b0d3468e8b962a51f68e354,f8ab1761c5b42ebc144b94418e33a7b10154f716,The-Banksy-House,0,0,0,0,0,0,0,0,0.0,0.0,0.0,25,0,,analises_projeto_lote/The-Banksy-House_declaration_001_e98e693_1756654785/before,analises_projeto_lote/The-Banksy-House_declaration_001_e98e693_1756654785/after
tyraziel/vibe-coder-license,64501336b7e3f1a2e5f58e6dd64fb479fcd7d80c,d315db66b849f3ec32c6b521a90ad9dd9262b60c,tyraziel,3,3,7139,7157,18,0,0,0,0.0,0.0,0.0,39,13,,analises_projeto_lote/tyraziel_vibe-coder-license_6450133_1756654790/before,analises_projeto_lote/tyraziel_vibe-coder-license_6450133_1756654790/after
perceptualrobots/chatgpt,eb0eb62870746a395b1b0422cad46710475a37ce,d5806d0f4127ca341affe6f8e73dc119c4c82760,perceptualrobots,22,23,1784,1831,47,117,122,5,2.854,2.711,-0.143,80,5,16.0,analises_projeto_lote/perceptualrobots_chatgpt_eb0eb62_1756654809/before,analises_projeto_lote/perceptualrobots_chatgpt_eb0eb62_1756654809/after
limcpf/econo-nyang,697b86fee9a1f894d0104a7f6c5b3caae5fcf1c8,1380693c73d55a6c160eddadd7cc8a0630914355,limcpf,51,57,4760,5810,1050,422,625,203,2.01,1.662,-0.348,1497,5,7.374,analises_projeto_lote/limcpf_econo-nyang_697b86f_1756654815/before,analises_projeto_lote/limcpf_econo-nyang_697b86f_1756654815/after
kadragon/knue-campus-counsel,1b103ed3df1abb5cd30640ba216332729ffa1f6e,312c85cf36df5ffba4cdfd1b255012accc92442b,knue-bot,30,31,3552,3768,216,223,246,23,1.411,1.382,-0.029,375,84,16.304,analises_projeto_lote/kadragon_knue-campus-counsel_1b103ed_1756655422/before,analises_projeto_lote/kadragon_knue-campus-counsel_1b103ed_1756655422/after
secira/tCapital,689aefef914c6c2c3b95f34b6e81f2b311c96a2c,7ef3ee20079c5d8708752e2956b3437612218f66,udayid,121,122,26331,26757,426,965,968,3,2.83,2.83,0.0,793,286,264.333,analises_projeto_lote/secira_tCapital_689aefe_1756655428/before,analises_projeto_lote/secira_tCapital_689aefe_1756655428/after
usagi917/council-dashboard-and-ai-chat,4b866ce5da1fe7d2c53dc160759e6be44bfadc0f,09cbe37e2ca2b4fe5614619e00cefeb30cb40990,usagi917,37,43,35784,36222,438,3942,3984,42,12.435,11.16,-1.275,757,3,18.024,analises_projeto_lote/usagi917_council-dashboard-and-ai-chat_4b866ce_1756655437/before,analises_projeto_lote/usagi917_council-dashboard-and-ai-chat_4b866ce_1756655437/after
kevinveenbirkenbach/infinito-nexus,26b392ea76d8a4c858d5abbfa6f8ed795d56e9ba,b49fdc509e81338a402003a17204ce0fd3b2819c,kevinveenbirkenbach,1839,1842,54416,54462,46,3118,3118,0,3.272,3.272,0.0,377,334,,analises_projeto_lote/kevinveenbirkenbach_infinito-nexus_26b392e_1756656045/before,analises_projeto_lote/kevinveenbirkenbach_infinito-nexus_26b392e_1756656045/after
SAP/ai-sdk-java,9605b667eee12eb137e648428fcc962dbea94759,275a736553b36950bb48642ba405da565f9e396c,n-o-u-r-h-a-n,840,850,117007,118083,1076,17531,17595,64,1.598,1.6,0.002,1240,14,19.375,analises_projeto_lote/SAP_ai-sdk-java_9605b66_1756656058/before,analises_projeto_lote/SAP_ai-sdk-java_9605b66_1756656058/after
KNOCKYONG/sona_app,7bfe89bcf4f98b533d46bbc7af31616eb4ffa5d1,8a5b4256fbed91d0594897872178e0e749d40c35,nohdol97,578,578,215473,215101,-372,11489,11459,-30,5.422,5.405,-0.017,66,487,2.2,analises_projeto_lote/KNOCKYONG_sona_app_7bfe89b_1756656074/before,analises_projeto_lote/KNOCKYONG_sona_app_7bfe89b_1756656074/after
secira/tCapital,f0a83acb086e955bb835102cb811f49c5caf6f74,ea229d282c0dadb9d8abec5d518526de9315bb57,udayid,114,116,23526,24393,867,666,728,62,2.763,2.811,0.048,1174,1,18.935,analises_projeto_lote/secira_tCapital_f0a83ac_1756657324/before,analises_projeto_lote/secira_tCapital_f0a83ac_1756657324/after
avisi-cloud/go-client,b9f3c11e2e982d2a2c8fa08f5b62f8be1eb43cb2,cd7a4cf3d66bcb33227dc9e41bf3a1f4269dd486,djmarkoz,38,39,2690,2733,43,318,331,13,2.288,2.299,0.011,49,0,3.769,analises_projeto_lote/avisi-cloud_go-client_b9f3c11_1756657333/before,analises_projeto_lote/avisi-cloud_go-client_b9f3c11_1756657333/after
avisi-cloud/go-client,cd7a4cf3d66bcb33227dc9e41bf3a1f4269dd486,c4292497349a05df81527db2d34ce3b32b7b4e6f,djmarkoz,38,38,2659,2690,31,313,318,5,2.301,2.288,-0.013,35,2,7.0,analises_projeto_lote/avisi-cloud_go-client_cd7a4cf_1756657339/before,analises_projeto_lote/avisi-cloud_go-client_cd7a4cf_1756657339/after
kevinveenbirkenbach/infinito-nexus,b49fdc509e81338a402003a17204ce0fd3b2819c,b1e8339283fab436df8bfa4e0d0da7a1cc440cb2,kevinveenbirkenbach,1838,1839,54396,54416,20,3118,3118,0,3.272,3.272,0.0,55,30,,analises_projeto_lote/kevinveenbirkenbach_infinito-nexus_b49fdc5_1756657345/before,analises_projeto_lote/kevinveenbirkenbach_infinito-nexus_b49fdc5_1756657345/after
scot00671234/AIForecast-Hub,d74226bb1fc5ec26140a6c7868b458d778899f49,75077a17ed81e6a56d131ce55e796938e7fcea7d,rehaven796,343,345,106763,111306,4543,750,761,11,1.576,1.595,0.019,99,0,9.0,analises_projeto_lote/scot00671234_AIForecast-Hub_d74226b_1756657359/before,analises_projeto_lote/scot00671234_AIForecast-Hub_d74226b_1756657359/after
alvaroybanez/jtbd-chat-dspy-v2,69696acf6c06b1147ab9199ccc304079bb21aee1,61ff781f82828fde523e45f795dffa29c3ba331a,alvaroybanez,60,71,12671,14864,2193,1244,1588,344,4.147,4.399,0.252,2446,118,7.11,analises_projeto_lote/alvaroybanez_jtbd-chat-dspy-v2_69696ac_1756657399/before,analises_projeto_lote/alvaroybanez_jtbd-chat-dspy-v2_69696ac_1756657399/after
steveg1983/wealthtracker-pro,f5aa3a2037759a0949cf11d23b75157dfae20c3f,a673450ff13f4e01e6f2f83660fb589ed7a55c5b,steveg1983,1401,1402,364965,365060,95,34762,34774,12,1.657,1.658,0.001,244,76,20.333,analises_projeto_lote/steveg1983_wealthtracker-pro_f5aa3a2_1756657406/before,analises_projeto_lote/steveg1983_wealthtracker-pro_f5aa3a2_1756657406/after
kevinveenbirkenbach/infinito-nexus,1082caddae3ddeeba6e218faa4882f200104dd90,242347878d2c76b472a212a6dc3f4ac90144de54,kevinveenbirkenbach,1838,1838,54385,54389,4,3118,3118,0,3.272,3.272,0.0,12,8,,analises_projeto_lote/kevinveenbirkenbach_infinito-nexus_1082cad_1756657479/before,analises_projeto_lote/kevinveenbirkenbach_infinito-nexus_1082cad_1756657479/after
itdojp/ae-framework,35c861c8be6feb5bab58a7db8ea37641b94e80bf,fc9b7dd66e9b221d31acb48027c4ebeeffe7d412,ootakazuhiko,412,418,117347,118187,840,4990,5029,39,1.498,1.499,0.001,1085,7,27.821,analises_projeto_lote/itdojp_ae-framework_35c861c_1756657492/before,analises_projeto_lote/itdojp_ae-framework_35c861c_1756657492/after
itdojp/ae-framework,fc9b7dd66e9b221d31acb48027c4ebeeffe7d412,2d393cddf41ac8a4e66d39eb0ae1040cbb59dc2d,ootakazuhiko,410,412,117024,117347,323,4914,4990,76,1.494,1.498,0.004,446,0,5.868,analises_projeto_lote/itdojp_ae-framework_fc9b7dd_1756657505/before,analises_projeto_lote/itdojp_ae-framework_fc9b7dd_1756657505/after
itdojp/ae-framework,2d393cddf41ac8a4e66d39eb0ae1040cbb59dc2d,153ded1b790a181493756ae9be118626ad77ead9,ootakazuhiko,408,410,116706,117024,318,4874,4914,40,1.495,1.494,-0.001,446,1,11.15,analises_projeto_lote/itdojp_ae-framework_2d393cd_1756657518/before,analises_projeto_lote/itdojp_ae-framework_2d393cd_1756657518/after
itdojp/ae-framework,153ded1b790a181493756ae9be118626ad77ead9,d0bb88ca76043c48a5a9fa37b6eaa0fb265ebdbe,ootakazuhiko,406,408,115963,116706,743,4847,4874,27,1.494,1.495,0.001,941,20,34.852,analises_projeto_lote/itdojp_ae-framework_153ded1_1756657531/before,analises_projeto_lote/itdojp_ae-framework_153ded1_1756657531/after
lirantal/chatgpt-security-model-ui,e57b33d8406c449d13cca520dee48f16d2caa935,d58ab0470288b9dd8161ad2da064871e3eb6c521,v0[bot],21,21,3518,3518,0,48,48,0,2.087,2.087,0.0,0,0,,analises_projeto_lote/lirantal_chatgpt-security-model-ui_e57b33d_1756657543/before,analises_projeto_lote/lirantal_chatgpt-security-model-ui_e57b33d_1756657543/after
sulthanqintara/chatgpt-app,8b9c50056f15e61324685dff4ab18753f3dcfe1d,afe2d0521709f816c763fa807964cd9ef2d67e04,sulthanqintara,21,24,3941,4121,180,39,48,9,1.219,1.2,-0.019,233,13,25.889,analises_projeto_lote/sulthanqintara_chatgpt-app_8b9c500_1756657549/before,analises_projeto_lote/sulthanqintara_chatgpt-app_8b9c500_1756657549/after
ronnydonkey/aarongreenberg-site,1f26b3b5aa21369e8a0278c5119a0eb674c3973c,94ed2154ca91b8f73ec99f9b7006046af65ffd49,ronnydonkey,35,35,13453,13510,57,267,248,-19,3.814,3.701,-0.113,80,39,4.211,analises_projeto_lote/ronnydonkey_aarongreenberg-site_1f26b3b_1756657556/before,analises_projeto_lote/ronnydonkey_aarongreenberg-site_1f26b3b_1756657556/after
TakumiYoshida777/CompactSkillSheetsApp,47034a05bead5fa64656c590e2cbf069db63f8d8,0bb06d4685bc027b2203655057e1d5e38eab9245,TakumiYoshida777,220,221,64691,64747,56,2567,2567,0,1.637,1.637,0.0,76,1,,analises_projeto_lote/TakumiYoshida777_CompactSkillSheetsApp_47034a0_1756657565/before,analises_projeto_lote/TakumiYoshida777_CompactSkillSheetsApp_47034a0_1756657565/after
JiaJunDeng5930/agentX,97f995a749a2cd8b4edf68d59edf6d18f4363825,f49c934cd08ee2157dce3c9fbe70f4541bba116d,aibrahim-oai,320,320,86055,86384,329,3886,3905,19,2.946,2.938,-0.008,440,33,23.158,analises_projeto_lote/JiaJunDeng5930_agentX_97f995a_1756657578/before,analises_projeto_lote/JiaJunDeng5930_agentX_97f995a_1756657578/after
tyraziel/vibe-coder-license,d315db66b849f3ec32c6b521a90ad9dd9262b60c,a9af59a1880f1ac5b355f4b05b56b29a6946e520,tyraziel,3,3,7136,7139,3,0,0,0,0.0,0.0,0.0,11,7,,analises_projeto_lote/tyraziel_vibe-coder-license_d315db6_1756657596/before,analises_projeto_lote/tyraziel_vibe-coder-license_d315db6_1756657596/after
Chrisdesmurger/lettercraft,b137d52265d71c8b394e02f3bc5aa0936713247d,49a6de41dc101a0791dc8e43420f7ed930460a77,Chrisdesmurger,229,231,42766,43087,321,1634,1672,38,2.147,2.186,0.039,843,191,22.184,analises_projeto_lote/Chrisdesmurger_lettercraft_b137d52_1756657616/before,analises_projeto_lote/Chrisdesmurger_lettercraft_b137d52_1756657616/after
WangziwenUnique/myclipboard,53e21eb515d29b2049febf7ba43d721a6e459b93,34c21efa026637b961b70ae1c41e2ba5884b414d,WangziwenUnique,70,71,11068,11144,76,411,411,0,2.569,2.569,0.0,98,0,,analises_projeto_lote/WangziwenUnique_myclipboard_53e21eb_1756657625/before,analises_projeto_lote/WangziwenUnique_myclipboard_53e21eb_1756657625/after
ElementsProject/lightning,b70f4f618402cba43e56b32dd82d6a51485d2733,2a191479a3e649cac682c0d63392ed66fd113773,rustyrussell,28679,28679,870828,870573,-255,67744,67725,-19,3.195,3.195,0.0,355,665,18.684,analises_projeto_lote/ElementsProject_lightning_b70f4f6_1756657633/before,analises_projeto_lote/ElementsProject_lightning_b70f4f6_1756657633/after
ElementsProject/lightning,568f12ea7111e62fb80d938f0387a57ea92c8f35,5dc88c9e84ef20d34ca8c1d07508afb1433a13e9,rustyrussell,28671,28671,870776,870756,-20,67653,67652,-1,3.202,3.202,0.0,3,28,3.0,analises_projeto_lote/ElementsProject_lightning_568f12e_1756657744/before,analises_projeto_lote/ElementsProject_lightning_568f12e_1756657744/after
TakumiYoshida777/CompactSkillSheetsApp,a085891a344239b7bc3da07bce1e72ed7b0cb77e,59cce675c7a61295caa4ce4b52598666767575f4,TakumiYoshida777,218,219,64387,64503,116,2517,2532,15,1.627,1.635,0.008,170,6,11.333,analises_projeto_lote/TakumiYoshida777_CompactSkillSheetsApp_a085891_1756657858/before,analises_projeto_lote/TakumiYoshida777_CompactSkillSheetsApp_a085891_1756657858/after
vstram/BrxAgente-desafio4,0db6bdc85587b08ca8fbb1e9d67fbdf5a416d4e7,d2a73dee159556c6b895b226256a1376587e21e6,vstram,73,76,8261,8782,521,664,710,46,2.604,2.563,-0.041,675,15,14.674,analises_projeto_lote/vstram_BrxAgente-desafio4_0db6bdc_1756657871/before,analises_projeto_lote/vstram_BrxAgente-desafio4_0db6bdc_1756657871/after
adrianwedd/grid2_repo,b0f0e1d8c26a7192ae2f16f4eb28799008b7285f,e942f509732168744bd889f61e0ac40d6d943d2c,adrianwedd,210,211,41464,43037,1573,1308,1333,25,1.901,1.902,0.001,1709,7,68.36,analises_projeto_lote/adrianwedd_grid2_repo_b0f0e1d_1756657879/before,analises_projeto_lote/adrianwedd_grid2_repo_b0f0e1d_1756657879/after
steveg1983/wealthtracker-pro,62896658c9d92a37e38dbd16b9c2ec4239ddc457,b58a762e564c8285e1f0008f2cf33e28a86d5b37,steveg1983,1433,1433,414086,414104,18,34671,34673,2,1.656,1.656,0.0,44,15,22.0,analises_projeto_lote/steveg1983_wealthtracker-pro_6289665_1756657887/before,analises_projeto_lote/steveg1983_wealthtracker-pro_6289665_1756657887/after
steveg1983/wealthtracker-pro,f8f6abbd3c62ce852261ef90d518148582f1a1bc,e346d3ab8e590304e745e2771c9bd9d2dd8e696a,steveg1983,1431,1433,413361,413968,607,34660,34671,11,1.656,1.656,0.0,750,128,68.182,analises_projeto_lote/steveg1983_wealthtracker-pro_f8f6abb_1756657977/before,analises_projeto_lote/steveg1983_wealthtracker-pro_f8f6abb_1756657977/after
KNOCKYONG/sona_app,bdb15342f3dfe32119d60fa538cc23be3c8e5b0e,ae5d10f520707f737605f92c23a223b2c9bb9ddc,KNOCKYONG,595,592,217727,216894,-833,11804,11459,-345,5.405,5.295,-0.11,300,1389,0.87,analises_projeto_lote/KNOCKYONG_sona_app_bdb1534_1756658071/before,analises_projeto_lote/KNOCKYONG_sona_app_bdb1534_1756658071/after
ryandens/javaagent-gradle-plugin,779cbe1447b6468ead8d805e3bae3426b0d9906c,c68e014b2d5c3a08bdc9b8d10dee62a886412125,renovate[bot],44,44,2587,2587,0,79,79,0,1.317,1.317,0.0,1,1,,analises_projeto_lote/ryandens_javaagent-gradle-plugin_779cbe1_1756658121/before,analises_projeto_lote/ryandens_javaagent-gradle-plugin_779cbe1_1756658121/after
LiamWhitenack/quotiac,0b58646da51d497bae199c0d10717d6726e774c2,84a02cbabaf1485e83504a4745937a55beac0646,LiamWhitenack,68,69,31596,31759,163,334,340,6,1.621,1.65,0.029,96,44,16.0,analises_projeto_lote/LiamWhitenack_quotiac_0b58646_1756658128/before,analises_projeto_lote/LiamWhitenack_quotiac_0b58646_1756658128/after
youbin2014/claude-gpt-collabration,601664a40e35763f129e69e7f79b46321c054155,ad34a01bc9992a099477e2e9f478dd0054987074,youbin2014,25,28,4052,5896,1844,68,100,32,1.943,2.703,0.76,2146,41,67.062,analises_projeto_lote/youbin2014_claude-gpt-collabration_601664a_1756658136/before,analises_projeto_lote/youbin2014_claude-gpt-collabration_601664a_1756658136/after
microsoft/onnxruntime-genai,b92970cbba32ab03eed8cc08607e78fd5504a15b,625815e715496d9943f7a4d5c672019265ab5ddb,kunal-vaishnavi,618,618,513950,513951,1,6292,6292,0,2.364,2.364,0.0,727,236,,analises_projeto_lote/microsoft_onnxruntime-genai_b92970c_1756658143/before,analises_projeto_lote/microsoft_onnxruntime-genai_b92970c_1756658143/after
kevinveenbirkenbach/infinito-nexus,185f37af522f5def3db5b110846d44fbe5ba018a,b9461026a6f2716b5685202c0cabccc5456771ac,kevinveenbirkenbach,1837,1837,54344,54366,22,3119,3119,0,3.273,3.273,0.0,76,44,,analises_projeto_lote/kevinveenbirkenbach_infinito-nexus_185f37a_1756659540/before,analises_projeto_lote/kevinveenbirkenbach_infinito-nexus_185f37a_1756659540/after
ElizaSystems/lyn,e908d76db56c45a7db2fa91eeef1c9b53251fbaa,aeb332a1e4ff87046b968a9c032b3f545880a7d8,awidearray,95,104,32006,32808,802,847,959,112,1.548,1.601,0.053,3653,2400,32.616,analises_projeto_lote/ElizaSystems_lyn_e908d76_1756659554/before,analises_projeto_lote/ElizaSystems_lyn_e908d76_1756659554/after
hongbo-miao/hongbomiao.com,7129e0410d3cff5c4f32a58937e3c4b589a1cd34,2050208324a19b12f3cfab5677d84a6b222585dc,renovate[bot],3161,3161,392830,392830,0,8682,8682,0,1.887,1.887,0.0,10,10,,analises_projeto_lote/hongbo-miao_hongbomiao.com_7129e04_1756659562/before,analises_projeto_lote/hongbo-miao_hongbomiao.com_7129e04_1756659562/after
Chitranjali/ChatGPT-extension,5feb52389cc75af6233408f798cba6c34ab139fa,0522a8f8c8e64e5d87bcc3f843cd17c88c3827bd,Chitranjali,4,4,399,403,4,14,14,0,1.167,1.167,0.0,7,3,,analises_projeto_lote/Chitranjali_ChatGPT-extension_5feb523_1756659966/before,analises_projeto_lote/Chitranjali_ChatGPT-extension_5feb523_1756659966/after
kevinveenbirkenbach/infinito-nexus,b9461026a6f2716b5685202c0cabccc5456771ac,bf63e01b984dd5cfbf1a635df95ccb8e73ddee25,kevinveenbirkenbach,1837,1837,54328,54344,16,3115,3119,4,3.269,3.273,0.004,36,21,9.0,analises_projeto_lote/kevinveenbirkenbach_infinito-nexus_b946102_1756659972/before,analises_projeto_lote/kevinveenbirkenbach_infinito-nexus_b946102_1756659972/after
yuartr/NeuroKey,42772a9aed125cdb48ccc62c7dd35ebe6f95f902,f5c2e1e16926155e71707207755b77293979c9e9,ioanarotar93,142,146,192726,193519,793,1609,1677,68,1.792,1.788,-0.004,1353,39,19.897,analises_projeto_lote/yuartr_NeuroKey_42772a9_1756659985/before,analises_projeto_lote/yuartr_NeuroKey_42772a9_1756659985/after
kevinveenbirkenbach/infinito-nexus,bf63e01b984dd5cfbf1a635df95ccb8e73ddee25,4a600ac53192559ba77abb4b59b77b47c3cfdd33,kevinveenbirkenbach,1836,1837,54298,54328,30,3110,3115,5,3.281,3.269,-0.012,63,23,12.6,analises_projeto_lote/kevinveenbirkenbach_infinito-nexus_bf63e01_1756660100/before,analises_projeto_lote/kevinveenbirkenbach_infinito-nexus_bf63e01_1756660100/after
sidedotdev/sidekick,fb22c354edc2fe0e08d11073baa835ccc0480ee3,d737f79ef00b53b937927ddc2b91457d2b9ce429,ehsanul,457,458,83585,84112,527,7297,7384,87,3.18,3.192,0.012,848,163,9.747,analises_projeto_lote/sidedotdev_sidekick_fb22c35_1756661313/before,analises_projeto_lote/sidedotdev_sidekick_fb22c35_1756661313/after
clarencetw/thewavess-ai-core,d6ae0d2cca595a5e8ccb496d28198f894cef2748,53c29f3b2419913e5421b027a40c36a6e9ef1c95,clarencetw,80,82,24045,24851,806,2508,2601,93,4.078,4.182,0.104,2008,901,21.591,analises_projeto_lote/clarencetw_thewavess-ai-core_d6ae0d2_1756661324/before,analises_projeto_lote/clarencetw_thewavess-ai-core_d6ae0d2_1756661324/after
MoAbdel/webclaudecode,dc73780c57721e03c8b948642c76925709a83b8f,9f7ceea68ecb31601d14ab1962101b3267b5da12,Mo Abdel,147,149,33190,33434,244,561,588,27,1.65,1.68,0.03,366,42,13.556,analises_projeto_lote/MoAbdel_webclaudecode_dc73780_1756661331/before,analises_projeto_lote/MoAbdel_webclaudecode_dc73780_1756661331/after
ksnyder-mtm/ai-prompt-trainer-nonprofits,bb70696ff3b56958f1ff38425933b88613c75bac,49516848c64f51e24c01620280651e8e6e52f959,ksnyder-mtm,19,29,17981,21980,3999,7,65,58,1.4,1.625,0.225,4410,63,76.034,analises_projeto_lote/ksnyder-mtm_ai-prompt-trainer-nonprofits_bb70696_1756661346/before,analises_projeto_lote/ksnyder-mtm_ai-prompt-trainer-nonprofits_bb70696_1756661346/after
itdojp/req2run-benchmark,7482cbfefd3436da19bdfe07250b8eea099f0b47,bbfaa6f2d20c800d0fc67b33e793ad4044249d14,ootakazuhiko,43,49,8836,10074,1238,697,697,0,3.916,3.916,0.0,1646,0,,analises_projeto_lote/itdojp_req2run-benchmark_7482cbf_1756661354/before,analises_projeto_lote/itdojp_req2run-benchmark_7482cbf_1756661354/after
lirantal/chatgpt-security-model-ui,d58ab0470288b9dd8161ad2da064871e3eb6c521,a27728c31bbee31aa606c8212ff401de3bb4503b,v0[bot],21,21,3518,3518,0,48,48,0,2.087,2.087,0.0,0,0,,analises_projeto_lote/lirantal_chatgpt-security-model-ui_d58ab04_1756661360/before,analises_projeto_lote/lirantal_chatgpt-security-model-ui_d58ab04_1756661360/after
lirantal/chatgpt-security-model-ui,a27728c31bbee31aa606c8212ff401de3bb4503b,a124b681f4905517080fb2f956bd5d6de32428b5,v0[bot],21,21,3518,3518,0,48,48,0,2.087,2.087,0.0,0,0,,analises_projeto_lote/lirantal_chatgpt-security-model-ui_a27728c_1756661366/before,analises_projeto_lote/lirantal_chatgpt-security-model-ui_a27728c_1756661366/after
itdojp/req2run-benchmark,448dac56ad2a72a312fc78f002a241d6d3a587f7,b9c3b094b4b5db43ba300de13a738cc909d60987,ootakazuhiko,41,43,8118,8611,493,697,697,0,3.916,3.916,0.0,692,55,,analises_projeto_lote/itdojp_req2run-benchmark_448dac5_1756661372/before,analises_projeto_lote/itdojp_req2run-benchmark_448dac5_1756661372/after
eimribar/ghostwriter-portal,8a3ec8a742dcc27f1f2f6f51560f78ed100dee39,377f6ed6bb8ddb668f6e9690191a418928a6d390,Eimri,119,119,24344,24306,-38,931,931,0,2.509,2.509,0.0,39,75,,analises_projeto_lote/eimribar_ghostwriter-portal_8a3ec8a_1756661378/before,analises_projeto_lote/eimribar_ghostwriter-portal_8a3ec8a_1756661378/after
OpenTermsArchive/GenAI-snapshots,8940b6d58eaf7f8f04384a9e2ee2b3453401be3b,48a232536c48e328263936214f6729db4ea2934c,OTA-Bot,157,157,66988,66988,0,4191,4191,0,3.888,3.888,0.0,2,2,,analises_projeto_lote/OpenTermsArchive_GenAI-snapshots_8940b6d_1756661386/before,analises_projeto_lote/OpenTermsArchive_GenAI-snapshots_8940b6d_1756661386/after
OpenTermsArchive/GenAI-snapshots,48a232536c48e328263936214f6729db4ea2934c,6f2775c7967f77aacf593b56dcc8c2a78d3b7ec4,OTA-Bot,157,157,66988,66988,0,4191,4191,0,3.888,3.888,0.0,2,2,,analises_projeto_lote/OpenTermsArchive_GenAI-snapshots_48a2325_1756661434/before,analises_projeto_lote/OpenTermsArchive_GenAI-snapshots_48a2325_1756661434/after
OpenTermsArchive/GenAI-snapshots,6f2775c7967f77aacf593b56dcc8c2a78d3b7ec4,94a69823f49c17160ad501bc31af87c737567b95,OTA-Bot,157,157,66988,66988,0,4191,4191,0,3.888,3.888,0.0,2,2,,analises_projeto_lote/OpenTermsArchive_GenAI-snapshots_6f2775c_1756662044/before,analises_projeto_lote/OpenTermsArchive_GenAI-snapshots_6f2775c_1756662044/after
OpenTermsArchive/GenAI-snapshots,94a69823f49c17160ad501bc31af87c737567b95,0eed65874c2f0ee0ee28724dcb3fee1f2c064678,OTA-Bot,157,157,66988,66988,0,4191,4191,0,3.888,3.888,0.0,2,2,,analises_projeto_lote/OpenTermsArchive_GenAI-snapshots_94a6982_1756662096/before,analises_projeto_lote/OpenTermsArchive_GenAI-snapshots_94a6982_1756662096/after
ribelo/ai-ox,a6fdbd8179233040032cac272c42f539fc4f7945,7099ad6e86e52ac6078cd68ff5a7544c5a181337,ribelo,189,189,24942,24939,-3,2362,2365,3,2.497,2.505,0.008,71,76,23.667,analises_projeto_lote/ribelo_ai-ox_a6fdbd8_1756662150/before,analises_projeto_lote/ribelo_ai-ox_a6fdbd8_1756662150/after
probelabs/big-brain,fa796e4dcd8afb59d68aa9d481693d76accd6301,e9e1a5fb07f48a10e9c267777d264544aef13f16,buger,39,39,7045,7052,7,372,372,0,1.806,1.806,0.0,9,2,,analises_projeto_lote/probelabs_big-brain_fa796e4_1756662157/before,analises_projeto_lote/probelabs_big-brain_fa796e4_1756662157/after
Sascha001/bachelorarbeit_neu,883340b2af53d00a93227ea3793bb233c27a828f,f589c708b35799a43d0d5a036adfc62184b3bd32,Sascha001,63,63,13877,14418,541,402,402,0,1.621,1.621,0.0,761,172,,analises_projeto_lote/Sascha001_bachelorarbeit_neu_883340b_1756662165/before,analises_projeto_lote/Sascha001_bachelorarbeit_neu_883340b_1756662165/after
JoaoPilger/HostNest-Hospedagens,d4302d7c1666113adf56d274f1f76ad115b41aa9,b27ff2af44b7dbfc8623c5610b741451a3ce2398,Qlqr1,35,35,6966,6992,26,136,139,3,1.943,1.958,0.015,137,94,45.667,analises_projeto_lote/JoaoPilger_HostNest-Hospedagens_d4302d7_1756662172/before,analises_projeto_lote/JoaoPilger_HostNest-Hospedagens_d4302d7_1756662172/after
milisp/codexia-vscode,fd84a622ea55d8e9eb5cbc07ee60fec2eb4c56f9,84a1fb56f4bcad5ceea42778cdc188293e886de3,milisp,75,77,29650,29642,-8,699,708,9,2.105,2.076,-0.029,222,235,24.667,analises_projeto_lote/milisp_codexia-vscode_fd84a62_1756662779/before,analises_projeto_lote/milisp_codexia-vscode_fd84a62_1756662779/after
loculus-project/loculus,5f11dfc6c1e12070c9b22cae2d3cc614dce82916,05bbbaad37eb7bcfadda0720d3b6b2f72588cc30,theosanderson,1014,1015,133149,133215,66,6427,6441,14,2.047,2.043,-0.004,83,10,5.929,analises_projeto_lote/loculus-project_loculus_5f11dfc_1756662786/before,analises_projeto_lote/loculus-project_loculus_5f11dfc_1756662786/after
CrackingShells/Hatchling,aaf29efd51fc3214f9419e849b8e1a68ff42db9c,3e13316c00f0368acb74cd4efa7d32815301f8e6,semantic-release-bot,147,147,40811,40827,16,1959,1959,0,2.843,2.843,0.0,29,0,,analises_projeto_lote/CrackingShells_Hatchling_aaf29ef_1756662804/before,analises_projeto_lote/CrackingShells_Hatchling_aaf29ef_1756662804/after
wmo4buva/loc-mcp-server,2c7f09576336b70a07326fc856ac0a724e2b5f9f,a282e0e621e66f7d4388b8fdd78e94f0adbee4c0,Mark Outten,10,10,2185,2242,57,42,42,0,1.909,1.909,0.0,39,4,,analises_projeto_lote/wmo4buva_loc-mcp-server_2c7f095_1756662816/before,analises_projeto_lote/wmo4buva_loc-mcp-server_2c7f095_1756662816/after
kevinveenbirkenbach/infinito-nexus,9756a0f75f178df131b89e559e2764c5aefbc4ee,e417bc19bd20a7f1d4d425c7ee3a0f59212f2882,kevinveenbirkenbach,1850,1853,55538,55727,189,3351,3390,39,3.331,3.301,-0.03,269,11,6.897,analises_projeto_lote/kevinveenbirkenbach_infinito-nexus_9756a0f_1756662822/before,analises_projeto_lote/kevinveenbirkenbach_infinito-nexus_9756a0f_1756662822/after
kevinveenbirkenbach/infinito-nexus,e417bc19bd20a7f1d4d425c7ee3a0f59212f2882,7ad14673e11bc5c89a9f017c32fe6564439d3ca7,kevinveenbirkenbach,1848,1850,55382,55538,156,3294,3351,57,3.327,3.331,0.004,289,101,5.07,analises_projeto_lote/kevinveenbirkenbach_infinito-nexus_e417bc1_1756662835/before,analises_projeto_lote/kevinveenbirkenbach_infinito-nexus_e417bc1_1756662835/after
yairbarak22/MCPServerStevia,cd993714ced0bfaf99554c09da8b5a83a75c15d8,423457dcfe38796e91a869f25846d610b09c2e05,yair.barak,14,18,4162,4516,354,366,385,19,7.32,6.754,-0.566,497,0,26.158,analises_projeto_lote/yairbarak22_MCPServerStevia_cd99371_1756662847/before,analises_projeto_lote/yairbarak22_MCPServerStevia_cd99371_1756662847/after
revred/Stroll,8c873a77954de4581c2fe2a101d556b789ef0855,9ff539149d8ca170e4e57ce281b38aea0334fe17,revred,23,62,549,70682,70133,72,1129,1057,3.429,3.495,0.066,10615,82,10.043,analises_projeto_lote/revred_Stroll_8c873a7_1756662853/before,analises_projeto_lote/revred_Stroll_8c873a7_1756662853/after
amywork777/RAGrecording,981833f532b009d2d3ae9f5e7b0f9bc9b33971a6,c5b79669bb5fc25745c664d3545ea331ba1a20b5,amywork777,39,41,24969,26254,1285,352,425,73,2.242,2.157,-0.085,1604,72,21.973,analises_projeto_lote/amywork777_RAGrecording_981833f_1756663223/before,analises_projeto_lote/amywork777_RAGrecording_981833f_1756663223/after
dsouza-anush/ai-financial-agent,0a8ced90ccf9b4bfe9a3587db97f55325f548955,a0f07b157af4d63c00029d4c802fb1ebaf866e68,Anush D'Souza,139,139,22592,22592,0,1417,1417,0,2.004,2.004,0.0,1,1,,analises_projeto_lote/dsouza-anush_ai-financial-agent_0a8ced9_1756663830/before,analises_projeto_lote/dsouza-anush_ai-financial-agent_0a8ced9_1756663830/after
kevinveenbirkenbach/infinito-nexus,7ad14673e11bc5c89a9f017c32fe6564439d3ca7,eb781dbf8b034eca73417de22d8ed200310c7148,kevinveenbirkenbach,1850,1848,55389,55382,-7,3294,3294,0,3.327,3.327,0.0,15,23,,analises_projeto_lote/kevinveenbirkenbach_infinito-nexus_7ad1467_1756663838/before,analises_projeto_lote/kevinveenbirkenbach_infinito-nexus_7ad1467_1756663838/after
adamlui/userscripts,95de4100fa0cba01ce85a07a283a16aed5d39c61,2762dfa18e35855bb0cf7d6d8ffbd63c8a355166,kudo-sync-bot,955,955,100842,100842,0,2056,2056,0,2.201,2.201,0.0,3,3,,analises_projeto_lote/adamlui_userscripts_95de410_1756663850/before,analises_projeto_lote/adamlui_userscripts_95de410_1756663850/after
KudoAI/chatgpt.js,c4011da06a727650caa44645a92abef14420a239,2c86bb79ffaf77ed6f6c5968e9b0524f13b8b8df,kudo-sync-bot,478,478,226182,226182,0,699,699,0,2.105,2.105,0.0,2,2,,analises_projeto_lote/KudoAI_chatgpt.js_c4011da_1756668234/before,analises_projeto_lote/KudoAI_chatgpt.js_c4011da_1756668234/after
adamlui/chatgpt-auto-continue,619c05d70fdd52e408a263cb18454e63c18352b1,b99bba1e79badf90bdd7ee37c415ce5121f6c01d,kudo-sync-bot,453,453,118982,118982,0,560,560,0,2.258,2.258,0.0,7,7,,analises_projeto_lote/adamlui_chatgpt-auto-continue_619c05d_1756670173/before,analises_projeto_lote/adamlui_chatgpt-auto-continue_619c05d_1756670173/after
adamlui/chatgpt-auto-continue,b99bba1e79badf90bdd7ee37c415ce5121f6c01d,ce3415657cb073b1159c55f7c7d81da8a539293f,kudo-sync-bot,453,453,118982,118982,0,560,560,0,2.258,2.258,0.0,29,29,,analises_projeto_lote/adamlui_chatgpt-auto-continue_b99bba1_1756670245/before,analises_projeto_lote/adamlui_chatgpt-auto-continue_b99bba1_1756670245/after
bluegreenmirror/loan-calculator-trial,06d43c9be7f0a5b87a5adbb79970e5639df1ce4c,5e2a0d43abd1a1c7757292053b292eeb0a839927,bluegreenmirror,18,18,584,584,0,8,8,0,2.0,2.0,0.0,40,38,,analises_projeto_lote/bluegreenmirror_loan-calculator-trial_06d43c9_1756672114/before,analises_projeto_lote/bluegreenmirror_loan-calculator-trial_06d43c9_1756672114/after
jackmaverick/overland-park-roofing,4544e5277366e82107cab404cbc07616fff2e7b0,6735dad888a8263654187e9928d8342f7bf37460,Jack,19,19,8566,8612,46,4,4,0,1.333,1.333,0.0,78,7,,analises_projeto_lote/jackmaverick_overland-park-roofing_4544e52_1756672120/before,analises_projeto_lote/jackmaverick_overland-park-roofing_4544e52_1756672120/after
bluegreenmirror/loan-calculator-trial,5e2a0d43abd1a1c7757292053b292eeb0a839927,f082a5615ac3e99276e38c7a903e40effd632df4,bluegreenmirror,18,18,584,584,0,8,8,0,2.0,2.0,0.0,8,2,,analises_projeto_lote/bluegreenmirror_loan-calculator-trial_5e2a0d4_1756672127/before,analises_projeto_lote/bluegreenmirror_loan-calculator-trial_5e2a0d4_1756672127/after
bluegreenmirror/loan-calculator-trial,f082a5615ac3e99276e38c7a903e40effd632df4,d481f068d1dd4d4b521c0dde93f4eb8acf08c86f,bluegreenmirror,18,18,584,584,0,8,8,0,2.0,2.0,0.0,34,2,,analises_projeto_lote/bluegreenmirror_loan-calculator-trial_f082a56_1756672133/before,analises_projeto_lote/bluegreenmirror_loan-calculator-trial_f082a56_1756672133/after
esora243/CreaMed,fc0c8a7684f103d3678d4b632a6543f6c3a2dc34,ad8a1d21184be01d9d2ff0feedcd7b7cce7a5284,esora243,32,32,43204,43263,59,17,17,0,1.889,1.889,0.0,60,0,,analises_projeto_lote/esora243_CreaMed_fc0c8a7_1756672139/before,analises_projeto_lote/esora243_CreaMed_fc0c8a7_1756672139/after
BOA-with-elephant/Header-backend,54063a630ad983d2522c376b11cb93dc5d871015,793af93dd22676161fceb816560c421304b62229,sortofel,246,249,15688,15842,154,1496,1513,17,1.956,1.967,0.011,221,39,13.0,analises_projeto_lote/BOA-with-elephant_Header-backend_54063a6_1756672166/before,analises_projeto_lote/BOA-with-elephant_Header-backend_54063a6_1756672166/after
bluegreenmirror/loan-calculator-trial,574893b7ed66ee2f8a28c7258c4c7e444e72230f,8d0e903933c190218f4d65c379378fdf0afbcdd7,bluegreenmirror,12,12,476,476,0,8,8,0,2.0,2.0,0.0,3,12,,analises_projeto_lote/bluegreenmirror_loan-calculator-trial_574893b_1756672174/before,analises_projeto_lote/bluegreenmirror_loan-calculator-trial_574893b_1756672174/after
ZNT1988/AlexIQ,ebf9c45d6a457fb2109f995bd7e9ab549b822750,3927ff312eb8d6b037d3578fbe5376ba3ce58613,AlexAI Developer,657,658,191601,191936,335,7872,7895,23,1.804,1.804,0.0,380,14,16.522,analises_projeto_lote/ZNT1988_AlexIQ_ebf9c45_1756672181/before,analises_projeto_lote/ZNT1988_AlexIQ_ebf9c45_1756672181/after
CrackingShells/Hatchling,913625f64c21fa10eae56600eca952ba5b387c40,52906b2fde06512ded11518aa43ecbb8dd45222d,semantic-release-bot,146,147,40792,40808,16,1959,1959,0,2.843,2.843,0.0,28,0,,analises_projeto_lote/CrackingShells_Hatchling_913625f_1756672208/before,analises_projeto_lote/CrackingShells_Hatchling_913625f_1756672208/after
bluegreenmirror/loan-calculator-trial,8d0e903933c190218f4d65c379378fdf0afbcdd7,b7abd21571dca6d47d2ed414955e08b7c5183507,bluegreenmirror,12,12,475,476,1,8,8,0,2.0,2.0,0.0,58,26,,analises_projeto_lote/bluegreenmirror_loan-calculator-trial_8d0e903_1756672220/before,analises_projeto_lote/bluegreenmirror_loan-calculator-trial_8d0e903_1756672220/after
change-challenge/VibeCoding_Pomodoro,e7ac8935e79b7fe8ab743c0517720bdfb8460fcd,a2bec22b6494cc3344b345759dd8c141e5591b4a,change-challenge,19,47,1342,50459,49117,115,115,0,2.17,2.17,0.0,145,0,,analises_projeto_lote/change-challenge_VibeCoding_Pomodoro_e7ac893_1756672226/before,analises_projeto_lote/change-challenge_VibeCoding_Pomodoro_e7ac893_1756672226/after
BOA-with-elephant/Header-backend,793af93dd22676161fceb816560c421304b62229,2f3ba3aae8f77d571573a45677c54fe519f59cc6,sortofel,246,246,15687,15688,1,1496,1496,0,1.956,1.956,0.0,2,1,,analises_projeto_lote/BOA-with-elephant_Header-backend_793af93_1756672260/before,analises_projeto_lote/BOA-with-elephant_Header-backend_793af93_1756672260/after
ZNT1988/AlexIQ,0256627477081f03ebe58c7f46dd03cf4d867882,b491a6b1309ee34932508d22d4f16d19bc405f18,AlexAI Developer,656,657,191446,191601,155,7853,7872,19,1.804,1.804,0.0,199,3,10.474,analises_projeto_lote/ZNT1988_AlexIQ_0256627_1756672268/before,analises_projeto_lote/ZNT1988_AlexIQ_0256627_1756672268/after
chyx/chat-syncer,f18d98770b7679a9c99cd4c95253f7bd53ecaf41,600b3513db960792b7c5f50bd6aca1e2bc2aafe0,chyx,13,14,2790,3455,665,294,350,56,2.333,2.244,-0.089,884,38,15.786,analises_projeto_lote/chyx_chat-syncer_f18d987_1756672296/before,analises_projeto_lote/chyx_chat-syncer_f18d987_1756672296/after
LucumaAgency/asistentev2,ab7cbf4b4079fac8cfae23fa6de704683ef170fe,30be5df53aa32a208fe7833a5a0aa5bbfbb0dc30,root,62,63,18863,18911,48,1026,1037,11,3.036,3.023,-0.013,65,3,5.909,analises_projeto_lote/LucumaAgency_asistentev2_ab7cbf4_1756672903/before,analises_projeto_lote/LucumaAgency_asistentev2_ab7cbf4_1756672903/after
surfmindsm/smart-yoram-backend,8fa0cc22f006f1251ebed82904028485c9b5aaef,8a33e7360f716bf39fa808010935eca4ad99c3d5,surfmindsm,274,274,29394,29418,24,1890,1893,3,3.677,3.683,0.006,34,2,11.333,analises_projeto_lote/surfmindsm_smart-yoram-backend_8fa0cc2_1756672910/before,analises_projeto_lote/surfmindsm_smart-yoram-backend_8fa0cc2_1756672910/after
BOA-with-elephant/Header-backend,2f3ba3aae8f77d571573a45677c54fe519f59cc6,39c0fe774e5ae475aa5e682be285f69d25091ed3,sortofel,246,246,15687,15687,0,1496,1496,0,1.956,1.956,0.0,1,1,,analises_projeto_lote/BOA-with-elephant_Header-backend_2f3ba3a_1756672918/before,analises_projeto_lote/BOA-with-elephant_Header-backend_2f3ba3a_1756672918/after
buildmoreandmore-cpu/levrx-exchange,becaf697b57bea6550abe68ad6d2d75eaa6194da,df3afa3d6af67e662139c180bce8220b18e0619e,Martin  Francis,0,0,0,0,0,0,0,0,0.0,0.0,0.0,340,12,,analises_projeto_lote/buildmoreandmore-cpu_levrx-exchange_becaf69_1756672926/before,analises_projeto_lote/buildmoreandmore-cpu_levrx-exchange_becaf69_1756672926/after
sspedowski/justice-document-pip,8e88aaf0c7901edd20b94af9e9e1bfeeca4417fe,7721219f55e227ec54cfa10be75f2a102c487eae,sspedowski,156,159,30253,31114,861,3422,3443,21,2.922,2.836,-0.086,1543,339,73.476,analises_projeto_lote/sspedowski_justice-document-pip_8e88aaf_1756672932/before,analises_projeto_lote/sspedowski_justice-document-pip_8e88aaf_1756672932/after
Visser09/Loop,90c4a6837956a0d9eb363bb6a39678bc1c4fdba1,d8a0d9b180134d3c7c8631dc2417a01cbca4288b,Visser09,106,106,26182,26180,-2,788,788,0,1.539,1.539,0.0,17,18,,analises_projeto_lote/Visser09_Loop_90c4a68_1756672941/before,analises_projeto_lote/Visser09_Loop_90c4a68_1756672941/after
blacknobilityenterprisellc-arch/OptiMind-AI-Ecosystem-,fd7e0848eb5c2daa39c09f0853de508e8d27cd5b,803fc404480a8ba87b9b2f6d59c00662f6dc81df,Z User,71,79,19801,21432,1631,448,572,124,1.329,1.43,0.101,3694,8,29.79,analises_projeto_lote/blacknobilityenterprisellc-arch_OptiMind-AI-Ecosystem-_fd7e084_1756672950/before,analises_projeto_lote/blacknobilityenterprisellc-arch_OptiMind-AI-Ecosystem-_fd7e084_1756672950/after
blacknobilityenterprisellc-arch/OptiMind-AI-Ecosystem1,fd7e0848eb5c2daa39c09f0853de508e8d27cd5b,803fc404480a8ba87b9b2f6d59c00662f6dc81df,Z User,71,79,19801,21432,1631,448,572,124,1.329,1.43,0.101,3694,8,29.79,analises_projeto_lote/blacknobilityenterprisellc-arch_OptiMind-AI-Ecosystem1_fd7e084_1756672959/before,analises_projeto_lote/blacknobilityenterprisellc-arch_OptiMind-AI-Ecosystem1_fd7e084_1756672959/after
BOA-with-elephant/Header-backend,39c0fe774e5ae475aa5e682be285f69d25091ed3,10141c26a0501f5828079407e72e1b35ca916d01,sortofel,239,246,15074,15687,613,1385,1496,111,1.882,1.956,0.074,906,72,8.162,analises_projeto_lote/BOA-with-elephant_Header-backend_39c0fe7_1756672967/before,analises_projeto_lote/BOA-with-elephant_Header-backend_39c0fe7_1756672967/after
adamlui/autoclear-chatgpt-history,5fbf68e992185d8d03bf144fb3c0580d79c07bf5,40e95d12aeebe7daf100f49e50b7e9ae425cf34b,kudo-sync-bot,199,199,62658,62656,-2,119,119,0,2.052,2.052,0.0,5,7,,analises_projeto_lote/adamlui_autoclear-chatgpt-history_5fbf68e_1756673579/before,analises_projeto_lote/adamlui_autoclear-chatgpt-history_5fbf68e_1756673579/after
rcz87/crypto-analysis-dashboard,67cff4ed09a7dec5b351dc075daf1397fc68833d,2becb7c0e7c17abd11f3dfe6243570a8d05c5a17,ricozap87,1140,1140,312288,312565,277,28495,28495,0,4.297,4.297,0.0,287,8,,analises_projeto_lote/rcz87_crypto-analysis-dashboard_67cff4e_1756674206/before,analises_projeto_lote/rcz87_crypto-analysis-dashboard_67cff4e_1756674206/after
adamlui/autoclear-chatgpt-history,40e95d12aeebe7daf100f49e50b7e9ae425cf34b,c2b874167d52c59fa7e48580069c2ea28d675c97,kudo-sync-bot,199,199,62651,62658,7,112,119,7,1.931,2.052,0.121,12,5,1.714,analises_projeto_lote/adamlui_autoclear-chatgpt-history_40e95d1_1756674251/before,analises_projeto_lote/adamlui_autoclear-chatgpt-history_40e95d1_1756674251/after
rcz87/crypto-analysis-dashboard,78d2f7a43d231a907dc808a8c52fd72ae0a5ae63,8d5746fc27f3edd8cd6ec0246e88c17de9c532be,ricozap87,1138,1140,310747,311868,1121,28407,28495,88,4.299,4.297,-0.002,1306,1,14.841,analises_projeto_lote/rcz87_crypto-analysis-dashboard_78d2f7a_1756674878/before,analises_projeto_lote/rcz87_crypto-analysis-dashboard_78d2f7a_1756674878/after
Dohanhub/doganahmetprofile,e8312cab66e284a88a11ec222bf2926d9c13e4fe,82f9f6322596689acff15fad79e7009e361fc1a5,ahmetdogan7,102,106,91444,164276,72832,5241,5312,71,1.268,1.281,0.013,509,18,7.169,analises_projeto_lote/Dohanhub_doganahmetprofile_e8312ca_1756674926/before,analises_projeto_lote/Dohanhub_doganahmetprofile_e8312ca_1756674926/after
spencebuilds/smartapply-architecture,ea235d3b1d23d01c798526fe783f40a6087046aa,e7eccd19e9b2c2205aeab5f81662c4b91bdec3b2,spencebuilds,0,0,0,0,0,0,0,0,0.0,0.0,0.0,248,0,,analises_projeto_lote/spencebuilds_smartapply-architecture_ea235d3_1756675110/before,analises_projeto_lote/spencebuilds_smartapply-architecture_ea235d3_1756675110/after
Clear-Learn-ai/clearlearn-ai,c04133741feb38138fcc8ed3837d91c78b7749fc,72afe13ce71a35ef8ceacd21f84de7b925635945,Clear-Learn-ai,25,31,86368,95627,9259,158,219,61,1.264,1.304,0.04,2628,55,43.082,analises_projeto_lote/Clear-Learn-ai_clearlearn-ai_c041337_1756675116/before,analises_projeto_lote/Clear-Learn-ai_clearlearn-ai_c041337_1756675116/after
amywork777/RAGrecording,8eee0c83ea809963839a7fe8bf234fcb837c73c9,d3b58cc8a377d469b106cdaef911d3d3dc82995a,yoswagenmans,29,32,22109,22510,401,108,137,29,1.543,1.691,0.148,524,66,18.069,analises_projeto_lote/amywork777_RAGrecording_8eee0c8_1756676268/before,analises_projeto_lote/amywork777_RAGrecording_8eee0c8_1756676268/after
amywork777/RAGrecording,d3b58cc8a377d469b106cdaef911d3d3dc82995a,8fff75cf7369ae696f022a0bb4362a808dd9a788,yoswagenmans,24,29,21192,22109,917,71,108,37,1.42,1.543,0.123,1338,19,36.162,analises_projeto_lote/amywork777_RAGrecording_d3b58cc_1756676275/before,analises_projeto_lote/amywork777_RAGrecording_d3b58cc_1756676275/after
ncadsxhvs/claude-example,99aec065a73ba07a52a599397405ea1449aa6393,9488a00c5924d2f0fe5236a45d56be6cc7ceebde,ddctu,84,89,28260,29087,827,653,827,174,1.526,1.563,0.037,1551,10,8.914,analises_projeto_lote/ncadsxhvs_claude-example_99aec06_1756676282/before,analises_projeto_lote/ncadsxhvs_claude-example_99aec06_1756676282/after
sanketmuchhala/AIStudyBuddy,e06b37a7d42b21fcb40b0f020d1b64b071f62623,51b29bd843ac44106710cc8b73f609b613284c68,sanketmuchhala,59,83,19531,28796,9265,753,860,107,1.711,1.68,-0.031,13507,3287,126.234,analises_projeto_lote/sanketmuchhala_AIStudyBuddy_e06b37a_1756676289/before,analises_projeto_lote/sanketmuchhala_AIStudyBuddy_e06b37a_1756676289/after
sanketmuchhala/AIStudyBuddy,d466cfa7532f65b0a58b270ef7926329a4c5eabb,a6eae46c435181acf9d16b9082c017d1ba637a3a,sanketmuchhala,59,80,19694,28463,8769,749,807,58,1.702,1.674,-0.028,12912,3287,222.621,analises_projeto_lote/sanketmuchhala_AIStudyBuddy_d466cfa_1756676313/before,analises_projeto_lote/sanketmuchhala_AIStudyBuddy_d466cfa_1756676313/after
The-Banksy-House/declaration_001,9be224bc9e650b161ee5d39e6e492f8713165114,57cd45fc397408552eed7a159bd084c81ce31a1a,The-Banksy-House,2,2,530,569,39,0,1,1,0.0,1.0,1.0,114,75,114.0,analises_projeto_lote/The-Banksy-House_declaration_001_9be224b_1756676337/before,analises_projeto_lote/The-Banksy-House_declaration_001_9be224b_1756676337/after
freedomofpress/securedrop,fb0b3e003b5e250107b730916cf180e54aac4c5c,bf39c6e74db1c727d6c6955795d8eb5739dc3732,cfm,940,940,175973,175994,21,4723,4723,0,2.151,2.151,0.0,45,21,,analises_projeto_lote/freedomofpress_securedrop_fb0b3e0_1756676343/before,analises_projeto_lote/freedomofpress_securedrop_fb0b3e0_1756676343/after
DrJsPBs/codex,783654e218c75ca00b43081c4d6a54a66d4c742f,e91c3d6d1cc050a9ca85d3460799f22c7d0541b9,ae-openai,322,322,86925,86925,0,3950,3950,0,2.924,2.924,0.0,6,7,,analises_projeto_lote/DrJsPBs_codex_783654e_1756676360/before,analises_projeto_lote/DrJsPBs_codex_783654e_1756676360/after
Charl-Moller/judy,4e91ea55699cbeb4607703ad9de0fc082f23895e,676ec7e27c84ba2ff9ac0e0cf57290a37e2c42c9,Charl-Moller,128,138,63151,66201,3050,2275,2811,536,3.134,3.432,0.298,5699,353,10.632,analises_projeto_lote/Charl-Moller_judy_4e91ea5_1756676379/before,analises_projeto_lote/Charl-Moller_judy_4e91ea5_1756676379/after
AmrutheshHD/finance-tracker,7b12320b3496330cd501ffb2062c0fa6c90fae9f,8e1027968b9550f7db4bec57f5ae18378e2fddf9,AmrutheshHD,11,37,1829,20940,19111,40,85,45,2.222,1.889,-0.333,19151,0,425.578,analises_projeto_lote/AmrutheshHD_finance-tracker_7b12320_1756676439/before,analises_projeto_lote/AmrutheshHD_finance-tracker_7b12320_1756676439/after
lee197/AI-Brain,8ad860fce56a12d4c9ad1fbfacec69923ad9fe6b,08251e86e9d551c9521e81563d35e9ac6be36c68,lee197,94,100,19876,20772,896,716,840,124,1.914,1.842,-0.072,2255,26,18.185,analises_projeto_lote/lee197_AI-Brain_8ad860f_1756676447/before,analises_projeto_lote/lee197_AI-Brain_8ad860f_1756676447/after
lee197/AI-Brain,08251e86e9d551c9521e81563d35e9ac6be36c68,9790fdc128a94a0009ffc57bcf34bdd16677edea,lee197,85,94,18122,19876,1754,558,716,158,1.86,1.914,0.054,3669,321,23.222,analises_projeto_lote/lee197_AI-Brain_08251e8_1756676454/before,analises_projeto_lote/lee197_AI-Brain_08251e8_1756676454/after
rcz87/crypto-analysis-dashboard,e2cef8f5bf36688675f9ac38be097b2aeea1753b,c2273731bf4e2714424a87e5d486540fb2de7b3b,ricozap87,1098,1099,286022,286054,32,26661,26661,0,4.259,4.259,0.0,62,0,,analises_projeto_lote/rcz87_crypto-analysis-dashboard_e2cef8f_1756676462/before,analises_projeto_lote/rcz87_crypto-analysis-dashboard_e2cef8f_1756676462/after
rcz87/crypto-analysis-dashboard,64f80f9670da7bee22d2e3e7627b19ac32597251,efa50dee5322d4df2c4c89aec70c694ca2a88041,ricozap87,1096,1097,283200,283297,97,26661,26661,0,4.259,4.259,0.0,111,1,,analises_projeto_lote/rcz87_crypto-analysis-dashboard_64f80f9_1756676504/before,analises_projeto_lote/rcz87_crypto-analysis-dashboard_64f80f9_1756676504/after
rcz87/crypto-analysis-dashboard,efa50dee5322d4df2c4c89aec70c694ca2a88041,730fcf30ab0e5a46022d953f033a675b3637eb3d,ricozap87,1095,1096,283107,283200,93,26660,26661,1,4.259,4.259,0.0,118,13,118.0,analises_projeto_lote/rcz87_crypto-analysis-dashboard_efa50de_1756676550/before,analises_projeto_lote/rcz87_crypto-analysis-dashboard_efa50de_1756676550/after
rcz87/crypto-analysis-dashboard,730fcf30ab0e5a46022d953f033a675b3637eb3d,dda754909552982c0c2e2374adee9213ff3d9514,ricozap87,1094,1095,282966,283107,141,26660,26660,0,4.259,4.259,0.0,169,0,,analises_projeto_lote/rcz87_crypto-analysis-dashboard_730fcf3_1756676596/before,analises_projeto_lote/rcz87_crypto-analysis-dashboard_730fcf3_1756676596/after
rcz87/crypto-analysis-dashboard,dda754909552982c0c2e2374adee9213ff3d9514,008b81fc24debe1a628b3d79cc1b9fd3e44bc5a8,ricozap87,1093,1094,282821,282966,145,26659,26660,1,4.26,4.259,-0.001,167,0,167.0,analises_projeto_lote/rcz87_crypto-analysis-dashboard_dda7549_1756676639/before,analises_projeto_lote/rcz87_crypto-analysis-dashboard_dda7549_1756676639/after
rcz87/crypto-analysis-dashboard,9812a0dcb34b4db81e3c95975c93026cd3c93773,f318e6b857fc9d59605c8ae68e8b304f6e9dc2dd,ricozap87,1090,1091,282516,282639,123,26656,26656,0,4.26,4.26,0.0,135,0,,analises_projeto_lote/rcz87_crypto-analysis-dashboard_9812a0d_1756676685/before,analises_projeto_lote/rcz87_crypto-analysis-dashboard_9812a0d_1756676685/after
rcz87/crypto-analysis-dashboard,f318e6b857fc9d59605c8ae68e8b304f6e9dc2dd,f28779d9677967ecb5a562ffda156320d4679bf2,ricozap87,1088,1090,280084,282516,2432,26655,26656,1,4.261,4.26,-0.001,65,0,65.0,analises_projeto_lote/rcz87_crypto-analysis-dashboard_f318e6b_1756676727/before,analises_projeto_lote/rcz87_crypto-analysis-dashboard_f318e6b_1756676727/after
rcz87/crypto-analysis-dashboard,f28779d9677967ecb5a562ffda156320d4679bf2,8d14553f96c1373a9e1cbad0681be826cbf11af5,ricozap87,1087,1088,280038,280084,46,26655,26655,0,4.261,4.261,0.0,58,0,,analises_projeto_lote/rcz87_crypto-analysis-dashboard_f28779d_1756676770/before,analises_projeto_lote/rcz87_crypto-analysis-dashboard_f28779d_1756676770/after
rcz87/crypto-analysis-dashboard,8d14553f96c1373a9e1cbad0681be826cbf11af5,18efa4f6e7c4735d57bfc39454ebf0eb76b27ec0,ricozap87,1086,1087,279504,280038,534,26648,26655,7,4.26,4.261,0.001,585,36,83.571,analises_projeto_lote/rcz87_crypto-analysis-dashboard_8d14553_1756676812/before,analises_projeto_lote/rcz87_crypto-analysis-dashboard_8d14553_1756676812/after
hyp3rd/ewrap,eedc583cbb8a05bf39645f4209d2912cc797e867,57a44e0bb17ba60b364abb1e56a8db8611c6570f,hyp3rd,66,68,7684,7759,75,908,921,13,2.322,2.314,-0.008,101,0,7.769,analises_projeto_lote/hyp3rd_ewrap_eedc583_1756676854/before,analises_projeto_lote/hyp3rd_ewrap_eedc583_1756676854/after
rcz87/crypto-analysis-dashboard,83aa41422455eed59edc5c672a413c39e994465c,7dd69c596667e911b9895483ce4929ad75edccaf,ricozap87,1083,1084,276837,276858,21,26644,26644,0,4.26,4.26,0.0,28,0,,analises_projeto_lote/rcz87_crypto-analysis-dashboard_83aa414_1756676861/before,analises_projeto_lote/rcz87_crypto-analysis-dashboard_83aa414_1756676861/after
hyp3rd/ewrap,a79178d7a892e923d693ca1d80603bca40a6b8ab,433159aaa9b585abcf82849a3b84a6ccae18fd8a,hyp3rd,66,66,7547,7675,128,868,906,38,2.278,2.323,0.045,160,2,4.211,analises_projeto_lote/hyp3rd_ewrap_a79178d_1756676904/before,analises_projeto_lote/hyp3rd_ewrap_a79178d_1756676904/after
hyp3rd/ewrap,433159aaa9b585abcf82849a3b84a6ccae18fd8a,4751004fc1ceb436c8d9bd1b30ab51d03bb9bc68,hyp3rd,64,66,7461,7547,86,857,868,11,2.291,2.278,-0.013,128,12,11.636,analises_projeto_lote/hyp3rd_ewrap_433159a_1756676911/before,analises_projeto_lote/hyp3rd_ewrap_433159a_1756676911/after
rcz87/crypto-analysis-dashboard,be8aa6892b471666da655b1963bcb42d44a26bce,0a847fab5dce034dc5b3cbc623560afc008cbe56,ricozap87,1070,1076,273948,275536,1588,26529,26566,37,4.249,4.252,0.003,1856,2,50.162,analises_projeto_lote/rcz87_crypto-analysis-dashboard_be8aa68_1756676918/before,analises_projeto_lote/rcz87_crypto-analysis-dashboard_be8aa68_1756676918/after
rcz87/crypto-analysis-dashboard,11add5aa02902b9511c69d24c408d790ccf0dde8,0fa5e73e1bda1067e1be57f2206d6f56185be4cb,ricozap87,1064,1068,272860,273658,798,26510,26525,15,4.255,4.251,-0.004,886,27,59.067,analises_projeto_lote/rcz87_crypto-analysis-dashboard_11add5a_1756676960/before,analises_projeto_lote/rcz87_crypto-analysis-dashboard_11add5a_1756676960/after
hyp3rd/ewrap,ff8ca7201f86b59e82bda041725dfb23806d18dd,af03a976da4053438b22cc246777eeab90a1ac90,hyp3rd,64,64,7449,7446,-3,854,854,0,2.29,2.29,0.0,45,53,,analises_projeto_lote/hyp3rd_ewrap_ff8ca72_1756677010/before,analises_projeto_lote/hyp3rd_ewrap_ff8ca72_1756677010/after
Zeletochoy/strinks,177d37f217343cd2ddae1e5af23bdce4a8593577,5540f55e25c1c17df1de84d346cac2e6a78c18d6,Zeletochoy,90,90,7608,7785,177,1090,1137,47,2.914,3.008,0.094,268,24,5.702,analises_projeto_lote/Zeletochoy_strinks_177d37f_1756677017/before,analises_projeto_lote/Zeletochoy_strinks_177d37f_1756677017/after
vaultaggregator/vaultaggregator,7702c6688445f11a49be702e926de54b70231dc4,233e97d35bab511525b59949555f69707317a40f,vaultaggregator,236,236,62372,62651,279,1697,1776,79,1.748,1.785,0.037,986,161,12.481,analises_projeto_lote/vaultaggregator_vaultaggregator_7702c66_1756678224/before,analises_projeto_lote/vaultaggregator_vaultaggregator_7702c66_1756678224/after
vaultaggregator/vaultaggregator,415577807a3e76e943fca4891cbda7d870aa269c,83e722d9ad8c92de78fee65e6a0f518b612196dc,vaultaggregator,236,237,62378,62509,131,1699,1725,26,1.753,1.751,-0.002,434,0,16.692,analises_projeto_lote/vaultaggregator_vaultaggregator_4155778_1756678246/before,analises_projeto_lote/vaultaggregator_vaultaggregator_4155778_1756678246/after
DrJsPBs/codex,97f995a749a2cd8b4edf68d59edf6d18f4363825,f49c934cd08ee2157dce3c9fbe70f4541bba116d,aibrahim-oai,320,320,86055,86384,329,3886,3905,19,2.946,2.938,-0.008,440,33,23.158,analises_projeto_lote/DrJsPBs_codex_97f995a_1756678267/before,analises_projeto_lote/DrJsPBs_codex_97f995a_1756678267/after
openai/codex,97f995a749a2cd8b4edf68d59edf6d18f4363825,f49c934cd08ee2157dce3c9fbe70f4541bba116d,aibrahim-oai,320,320,86055,86384,329,3886,3905,19,2.946,2.938,-0.008,440,33,23.158,analises_projeto_lote/openai_codex_97f995a_1756678284/before,analises_projeto_lote/openai_codex_97f995a_1756678284/after
adamlui/userscripts,485e1e019e5d9839b8318d3c1c96f0bd29f6cc51,187281f9a1847ce195829374a408bebb192d9541,kudo-sync-bot,955,955,100841,100841,0,2056,2056,0,2.201,2.201,0.0,2,2,,analises_projeto_lote/adamlui_userscripts_485e1e0_1756678302/before,analises_projeto_lote/adamlui_userscripts_485e1e0_1756678302/after
GeorgeMcIntyre-Web/NitroAGI,39bbcbfe206f83ebcddc39090f8e1d8e421791bb,97e78d12ae8b2bbbc1aa775d9e4c813cb86600a3,George McIntyre,110,115,25571,27314,1743,2800,2993,193,2.797,2.797,0.0,2241,25,11.611,analises_projeto_lote/GeorgeMcIntyre-Web_NitroAGI_39bbcbf_1756678919/before,analises_projeto_lote/GeorgeMcIntyre-Web_NitroAGI_39bbcbf_1756678919/after
adamlui/userscripts,ec63febf1ed3997c30aa17264e6b352182692fe5,e30acfe03dc54af6b2f5ee8ca5db358191ce8e9d,kudo-sync-bot,955,955,100841,100841,0,2056,2056,0,2.201,2.201,0.0,2,2,,analises_projeto_lote/adamlui_userscripts_ec63feb_1756678926/before,analises_projeto_lote/adamlui_userscripts_ec63feb_1756678926/after
adamlui/chatgpt-infinity,41563e342caa73795d07622cb6e7214959d340a7,cd4ba54bac6c6c23338df10fd792b3b6118cd131,kudo-sync-bot,487,487,109704,109704,0,674,674,0,2.167,2.167,0.0,2,2,,analises_projeto_lote/adamlui_chatgpt-infinity_41563e3_1756678942/before,analises_projeto_lote/adamlui_chatgpt-infinity_41563e3_1756678942/after
adamlui/userscripts,e30acfe03dc54af6b2f5ee8ca5db358191ce8e9d,a34891f9bca284d29e3ae7a3d0149e5d691fa23a,kudo-sync-bot,955,955,100841,100841,0,2056,2056,0,2.201,2.201,0.0,2,2,,analises_projeto_lote/adamlui_userscripts_e30acfe_1756679009/before,analises_projeto_lote/adamlui_userscripts_e30acfe_1756679009/after
adamlui/chatgpt-widescreen,a7ad75507a4f15fa6113c967ed5a50ea4c3243dc,5ca9371006d93191564d9214e0ddb64792591b16,kudo-sync-bot,458,458,119428,119428,0,854,854,0,2.201,2.201,0.0,2,2,,analises_projeto_lote/adamlui_chatgpt-widescreen_a7ad755_1756679025/before,analises_projeto_lote/adamlui_chatgpt-widescreen_a7ad755_1756679025/after
zocimek/home-ops,bcf3b18ac07797297702c1b515081eea148544b6,157116750d0546a9b1c0f71e24cba65925d7b0f5,renovate[bot],495,495,18608,18608,0,21,21,0,1.909,1.909,0.0,1,1,,analises_projeto_lote/zocimek_home-ops_bcf3b18_1756679089/before,analises_projeto_lote/zocimek_home-ops_bcf3b18_1756679089/after
zocimek/home-ops,157116750d0546a9b1c0f71e24cba65925d7b0f5,cc8fbe0962f1afdaa1f269a1ff956e353d043d0e,renovate[bot],495,495,18608,18608,0,21,21,0,1.909,1.909,0.0,1,1,,analises_projeto_lote/zocimek_home-ops_1571167_1756679096/before,analises_projeto_lote/zocimek_home-ops_1571167_1756679096/after
adamlui/chatgpt-widescreen,5ca9371006d93191564d9214e0ddb64792591b16,1df054674a34b9c51c2fe7963ede8f012cd82009,kudo-sync-bot,458,458,119430,119428,-2,854,854,0,2.201,2.201,0.0,2,4,,analises_projeto_lote/adamlui_chatgpt-widescreen_5ca9371_1756679104/before,analises_projeto_lote/adamlui_chatgpt-widescreen_5ca9371_1756679104/after
adamlui/userscripts,4b0e45691052b7bc518839a0b06a70fc60068ab5,a9b49eeaa6bd83afaf5b4d425bfabaa277d6763b,kudo-sync-bot,955,955,100841,100841,0,2056,2056,0,2.201,2.201,0.0,2,2,,analises_projeto_lote/adamlui_userscripts_4b0e456_1756679168/before,analises_projeto_lote/adamlui_userscripts_4b0e456_1756679168/after
adamlui/userscripts,a9b49eeaa6bd83afaf5b4d425bfabaa277d6763b,3a9786c11cbdff1c2967d59f3ecd314ade539e8c,kudo-sync-bot,955,955,100841,100841,0,2056,2056,0,2.201,2.201,0.0,2,2,,analises_projeto_lote/adamlui_userscripts_a9b49ee_1756679184/before,analises_projeto_lote/adamlui_userscripts_a9b49ee_1756679184/after
adamlui/userscripts,3a9786c11cbdff1c2967d59f3ecd314ade539e8c,a238fb957f79b71ee3bba2c57eac35074c7d3cf7,kudo-sync-bot,955,955,100841,100841,0,2056,2056,0,2.201,2.201,0.0,2,2,,analises_projeto_lote/adamlui_userscripts_3a9786c_1756679200/before,analises_projeto_lote/adamlui_userscripts_3a9786c_1756679200/after
adamlui/userscripts,a238fb957f79b71ee3bba2c57eac35074c7d3cf7,56023debd0f81c4b36f1b63cb52d3a8b600a2892,kudo-sync-bot,955,955,100841,100841,0,2056,2056,0,2.201,2.201,0.0,2,2,,analises_projeto_lote/adamlui_userscripts_a238fb9_1756679216/before,analises_projeto_lote/adamlui_userscripts_a238fb9_1756679216/after
adamlui/userscripts,56023debd0f81c4b36f1b63cb52d3a8b600a2892,937bc4e717cea53fcedfdd9ae793f2060612c158,kudo-sync-bot,955,955,100841,100841,0,2056,2056,0,2.201,2.201,0.0,2,2,,analises_projeto_lote/adamlui_userscripts_56023de_1756679232/before,analises_projeto_lote/adamlui_userscripts_56023de_1756679232/after
adamlui/chatgpt-auto-refresh,160e49bd5fe100bf4b7495daa2174449cff1071c,46ca23e0b84693b2b71d41567dafa4f13c771d9a,kudo-sync-bot,215,215,21609,21609,0,119,119,0,2.288,2.288,0.0,2,2,,analises_projeto_lote/adamlui_chatgpt-auto-refresh_160e49b_1756679247/before,analises_projeto_lote/adamlui_chatgpt-auto-refresh_160e49b_1756679247/after
adamlui/chatgpt-widescreen,1df054674a34b9c51c2fe7963ede8f012cd82009,8d21150b92761e61afa733eac65f459547a00d55,kudo-sync-bot,458,458,119430,119430,0,854,854,0,2.201,2.201,0.0,2,2,,analises_projeto_lote/adamlui_chatgpt-widescreen_1df0546_1756679258/before,analises_projeto_lote/adamlui_chatgpt-widescreen_1df0546_1756679258/after
adamlui/userscripts,937bc4e717cea53fcedfdd9ae793f2060612c158,0cffc68f216812bf469f4179fb356f0d34880c9f,kudo-sync-bot,955,955,100841,100841,0,2056,2056,0,2.201,2.201,0.0,2,2,,analises_projeto_lote/adamlui_userscripts_937bc4e_1756679320/before,analises_projeto_lote/adamlui_userscripts_937bc4e_1756679320/after
adamlui/chatgpt-infinity,cd4ba54bac6c6c23338df10fd792b3b6118cd131,016afb425b3e4af36abf5c2a2f2bb14b4126659b,kudo-sync-bot,487,487,109704,109704,0,674,674,0,2.167,2.167,0.0,2,2,,analises_projeto_lote/adamlui_chatgpt-infinity_cd4ba54_1756679336/before,analises_projeto_lote/adamlui_chatgpt-infinity_cd4ba54_1756679336/after
OpenTermsArchive/GenAI-snapshots,ff29e6cd14be857097ca60a834af43eb119ab513,e4109771a81ffeed058fd3c91bf1d09849d58c07,OTA-Bot,148,148,66249,66249,0,4176,4176,0,3.899,3.899,0.0,2,2,,analises_projeto_lote/OpenTermsArchive_GenAI-snapshots_ff29e6c_1756679410/before,analises_projeto_lote/OpenTermsArchive_GenAI-snapshots_ff29e6c_1756679410/after
OpenTermsArchive/GenAI-snapshots,e4109771a81ffeed058fd3c91bf1d09849d58c07,766b2c8ad1b6fab3d4fe07eac940ab0056a09c62,OTA-Bot,148,148,66249,66249,0,4176,4176,0,3.899,3.899,0.0,2,2,,analises_projeto_lote/OpenTermsArchive_GenAI-snapshots_e410977_1756679458/before,analises_projeto_lote/OpenTermsArchive_GenAI-snapshots_e410977_1756679458/after
OpenTermsArchive/GenAI-snapshots,766b2c8ad1b6fab3d4fe07eac940ab0056a09c62,329042a6da20ad06f90d977b759563950d72ba23,OTA-Bot,148,148,66249,66249,0,4176,4176,0,3.899,3.899,0.0,2,2,,analises_projeto_lote/OpenTermsArchive_GenAI-snapshots_766b2c8_1756679509/before,analises_projeto_lote/OpenTermsArchive_GenAI-snapshots_766b2c8_1756679509/after
OpenTermsArchive/GenAI-snapshots,329042a6da20ad06f90d977b759563950d72ba23,0de460d9557581712e988170ee32d2e83f8bf088,OTA-Bot,148,148,66249,66249,0,4176,4176,0,3.899,3.899,0.0,2,2,,analises_projeto_lote/OpenTermsArchive_GenAI-snapshots_329042a_1756679566/before,analises_projeto_lote/OpenTermsArchive_GenAI-snapshots_329042a_1756679566/after
OpenTermsArchive/GenAI-snapshots,f57c1aa4c6a2992b175c45b68c75b47a3598f0db,c0d4a1c4f2916752f888e2cbc8920f5689be1738,OTA-Bot,148,148,66249,66249,0,4176,4176,0,3.899,3.899,0.0,1,1,,analises_projeto_lote/OpenTermsArchive_GenAI-snapshots_f57c1aa_1756679615/before,analises_projeto_lote/OpenTermsArchive_GenAI-snapshots_f57c1aa_1756679615/after
OpenTermsArchive/GenAI-snapshots,0de460d9557581712e988170ee32d2e83f8bf088,f57c1aa4c6a2992b175c45b68c75b47a3598f0db,OTA-Bot,148,148,66249,66249,0,4176,4176,0,3.899,3.899,0.0,2,2,,analises_projeto_lote/OpenTermsArchive_GenAI-snapshots_0de460d_1756679664/before,analises_projeto_lote/OpenTermsArchive_GenAI-snapshots_0de460d_1756679664/after
OpenTermsArchive/GenAI-snapshots,c0d4a1c4f2916752f888e2cbc8920f5689be1738,7f555598f6b7ab4b37a81729ff2d2ed4121b1930,OTA-Bot,148,148,66249,66249,0,4176,4176,0,3.899,3.899,0.0,2,2,,analises_projeto_lote/OpenTermsArchive_GenAI-snapshots_c0d4a1c_1756679710/before,analises_projeto_lote/OpenTermsArchive_GenAI-snapshots_c0d4a1c_1756679710/after
OpenTermsArchive/GenAI-snapshots,7f555598f6b7ab4b37a81729ff2d2ed4121b1930,d67b95045fc8d2b4d20ffa2b14f5498b83c5d956,OTA-Bot,148,148,66249,66249,0,4176,4176,0,3.899,3.899,0.0,1,1,,analises_projeto_lote/OpenTermsArchive_GenAI-snapshots_7f55559_1756679756/before,analises_projeto_lote/OpenTermsArchive_GenAI-snapshots_7f55559_1756679756/after
OpenTermsArchive/GenAI-snapshots,d67b95045fc8d2b4d20ffa2b14f5498b83c5d956,ecd702c22a0c41f50657345f753a1d2032160d0a,OTA-Bot,148,148,66249,66249,0,4176,4176,0,3.899,3.899,0.0,2,2,,analises_projeto_lote/OpenTermsArchive_GenAI-snapshots_d67b950_1756679803/before,analises_projeto_lote/OpenTermsArchive_GenAI-snapshots_d67b950_1756679803/after
OpenTermsArchive/GenAI-snapshots,ecd702c22a0c41f50657345f753a1d2032160d0a,aebdc754b9165a759931ff2f1b7b8806f964e6e9,OTA-Bot,148,148,66249,66249,0,4176,4176,0,3.899,3.899,0.0,2,2,,analises_projeto_lote/OpenTermsArchive_GenAI-snapshots_ecd702c_1756679851/before,analises_projeto_lote/OpenTermsArchive_GenAI-snapshots_ecd702c_1756679851/after
OpenTermsArchive/GenAI-snapshots,aebdc754b9165a759931ff2f1b7b8806f964e6e9,e9bc96363d96f1ca32df4532a49aee942ede533c,OTA-Bot,148,148,66249,66249,0,4176,4176,0,3.899,3.899,0.0,1,1,,analises_projeto_lote/OpenTermsArchive_GenAI-snapshots_aebdc75_1756679896/before,analises_projeto_lote/OpenTermsArchive_GenAI-snapshots_aebdc75_1756679896/after
OpenTermsArchive/GenAI-snapshots,e9bc96363d96f1ca32df4532a49aee942ede533c,264af9a6b082af48156d68312d7a53423295162a,OTA-Bot,148,148,66249,66249,0,4176,4176,0,3.899,3.899,0.0,2,2,,analises_projeto_lote/OpenTermsArchive_GenAI-snapshots_e9bc963_1756679945/before,analises_projeto_lote/OpenTermsArchive_GenAI-snapshots_e9bc963_1756679945/after
OpenTermsArchive/GenAI-snapshots,264af9a6b082af48156d68312d7a53423295162a,363a6b31ca0dc384ed407a4b9ae460ee58fab1c9,OTA-Bot,148,148,66249,66249,0,4176,4176,0,3.899,3.899,0.0,2,2,,analises_projeto_lote/OpenTermsArchive_GenAI-snapshots_264af9a_1756679991/before,analises_projeto_lote/OpenTermsArchive_GenAI-snapshots_264af9a_1756679991/after
OpenTermsArchive/GenAI-snapshots,363a6b31ca0dc384ed407a4b9ae460ee58fab1c9,44c83b2e7e37ac8eb27bb333bb1ac10c3b7fc1f8,OTA-Bot,148,148,66249,66249,0,4176,4176,0,3.899,3.899,0.0,2,2,,analises_projeto_lote/OpenTermsArchive_GenAI-snapshots_363a6b3_1756680039/before,analises_projeto_lote/OpenTermsArchive_GenAI-snapshots_363a6b3_1756680039/after
OpenTermsArchive/GenAI-snapshots,44c83b2e7e37ac8eb27bb333bb1ac10c3b7fc1f8,6fd9b2a99b06be14067eed43156cc7046f798246,OTA-Bot,148,148,66249,66249,0,4176,4176,0,3.899,3.899,0.0,2,2,,analises_projeto_lote/OpenTermsArchive_GenAI-snapshots_44c83b2_1756680087/before,analises_projeto_lote/OpenTermsArchive_GenAI-snapshots_44c83b2_1756680087/after
adamlui/chatgpt-widescreen,8d21150b92761e61afa733eac65f459547a00d55,f5c2178bba5c0cd518158dd51d86fb4b0594da1b,kudo-sync-bot,458,458,119438,119430,-8,858,854,-4,2.2,2.201,0.001,6,14,1.5,analises_projeto_lote/adamlui_chatgpt-widescreen_8d21150_1756680139/before,analises_projeto_lote/adamlui_chatgpt-widescreen_8d21150_1756680139/after
Sascha001/bachelorarbeit_neu,3e49fd4a4d0877f3bd10ea83dcafc046e6976288,3a524f724e697296ce0f6d06f257dd7ab9696335,Sascha001,63,63,13710,13788,78,388,401,13,1.584,1.617,0.033,119,21,9.154,analises_projeto_lote/Sascha001_bachelorarbeit_neu_3e49fd4_1756680194/before,analises_projeto_lote/Sascha001_bachelorarbeit_neu_3e49fd4_1756680194/after
Sascha001/bachelorarbeit_neu,da634423dba01898ff7765b9d62359d5f52bd436,72dd1d46a53672da076783c665e9dd0e2f0ff196,Sascha001,63,63,13376,13710,334,390,387,-3,1.618,1.586,-0.032,445,20,148.333,analises_projeto_lote/Sascha001_bachelorarbeit_neu_da63442_1756680201/before,analises_projeto_lote/Sascha001_bachelorarbeit_neu_da63442_1756680201/after
ZNT1988/AlexIQ,12fedb6c3bbdb9f1d6cbeba77f84521e94aaa5c0,43a3f7e9a4d766f9d67ae27ee3bae44e4317fcc0,AlexAI Developer,563,566,172969,176005,3036,6808,6870,62,1.854,1.859,0.005,3998,30,64.484,analises_projeto_lote/ZNT1988_AlexIQ_12fedb6_1756684985/before,analises_projeto_lote/ZNT1988_AlexIQ_12fedb6_1756684985/after
GeorgeMcIntyre-Web/NitroAGI,d9b7ff0b8e1b6171e168734f32810b2ea214d8f1,cc2fca0045f8ba5cf6b14730ac2cf5b89d4baf9b,George McIntyre,10,47,2893,8307,5414,1,703,702,1.0,2.594,1.594,8451,78,12.038,analises_projeto_lote/GeorgeMcIntyre-Web_NitroAGI_d9b7ff0_1756685614/before,analises_projeto_lote/GeorgeMcIntyre-Web_NitroAGI_d9b7ff0_1756685614/after
probelabs/big-brain,239140cdc5d3233d58879fa0f0fab06749920fe0,1b28bd6b84b7cd04996e90fabf148b5a5a62cdb6,buger,38,38,6763,6790,27,365,365,0,1.825,1.825,0.0,30,3,,analises_projeto_lote/probelabs_big-brain_239140c_1756685621/before,analises_projeto_lote/probelabs_big-brain_239140c_1756685621/after
adamlui/chatgpt-widescreen,f5c2178bba5c0cd518158dd51d86fb4b0594da1b,35f38dcaf14b51f9dad73def63be2b9f8b271161,kudo-sync-bot,458,458,119438,119438,0,858,858,0,2.2,2.2,0.0,2,2,,analises_projeto_lote/adamlui_chatgpt-widescreen_f5c2178_1756687439/before,analises_projeto_lote/adamlui_chatgpt-widescreen_f5c2178_1756687439/after
adamlui/userscripts,dff874239c3016fadb57612140ad5f85e08d99c9,e03e41b9e5e3272653cba375dc3ae07b12ade34d,kudo-sync-bot,955,955,100843,100841,-2,2058,2056,-2,2.201,2.201,0.0,5,7,2.5,analises_projeto_lote/adamlui_userscripts_dff8742_1756687503/before,analises_projeto_lote/adamlui_userscripts_dff8742_1756687503/after
adamlui/userscripts,e03e41b9e5e3272653cba375dc3ae07b12ade34d,bdd9482abc9e45899c225003330402b9b458b751,kudo-sync-bot,955,955,100845,100843,-2,2060,2058,-2,2.201,2.201,0.0,5,7,2.5,analises_projeto_lote/adamlui_userscripts_e03e41b_1756687520/before,analises_projeto_lote/adamlui_userscripts_e03e41b_1756687520/after
adamlui/userscripts,bdd9482abc9e45899c225003330402b9b458b751,279d352640341e68e96aabf1e9b2e8003311b26c,kudo-sync-bot,955,955,100850,100845,-5,2064,2060,-4,2.203,2.201,-0.002,6,11,1.5,analises_projeto_lote/adamlui_userscripts_bdd9482_1756687536/before,analises_projeto_lote/adamlui_userscripts_bdd9482_1756687536/after
adamlui/userscripts,279d352640341e68e96aabf1e9b2e8003311b26c,3f3d93ec4b9a4a2d10088d38d5f79306b473be1a,kudo-sync-bot,955,955,100855,100850,-5,2068,2064,-4,2.205,2.203,-0.002,6,11,1.5,analises_projeto_lote/adamlui_userscripts_279d352_1756687552/before,analises_projeto_lote/adamlui_userscripts_279d352_1756687552/after
adamlui/chatgpt-infinity,016afb425b3e4af36abf5c2a2f2bb14b4126659b,49d73a74a6cc13c7f0ed70b11f4527171c52af1f,kudo-sync-bot,487,487,109709,109704,-5,678,674,-4,2.173,2.167,-0.006,6,11,1.5,analises_projeto_lote/adamlui_chatgpt-infinity_016afb4_1756687570/before,analises_projeto_lote/adamlui_chatgpt-infinity_016afb4_1756687570/after
adamlui/userscripts,3f3d93ec4b9a4a2d10088d38d5f79306b473be1a,7108e5bd9c96be6242af05e0aedd0e2713ee87ab,kudo-sync-bot,955,955,100857,100855,-2,2070,2068,-2,2.204,2.205,0.001,5,7,2.5,analises_projeto_lote/adamlui_userscripts_3f3d93e_1756687644/before,analises_projeto_lote/adamlui_userscripts_3f3d93e_1756687644/after
adamlui/chatgpt-auto-refresh,46ca23e0b84693b2b71d41567dafa4f13c771d9a,5ef479de34fba3dc16f3bce93cbe739f0c62e845,kudo-sync-bot,215,215,21611,21609,-2,121,119,-2,2.283,2.288,0.005,5,7,2.5,analises_projeto_lote/adamlui_chatgpt-auto-refresh_46ca23e_1756687662/before,analises_projeto_lote/adamlui_chatgpt-auto-refresh_46ca23e_1756687662/after
adamlui/userscripts,7108e5bd9c96be6242af05e0aedd0e2713ee87ab,58d1cdf80ca8e9624c74cdcc3cb0323691f9ac98,kudo-sync-bot,955,955,100857,100857,0,2070,2070,0,2.204,2.204,0.0,3,3,,analises_projeto_lote/adamlui_userscripts_7108e5b_1756687673/before,analises_projeto_lote/adamlui_userscripts_7108e5b_1756687673/after
adamlui/chatgpt-widescreen,35f38dcaf14b51f9dad73def63be2b9f8b271161,5e5928737c3348704c66a67da1e566d34b5c5a53,kudo-sync-bot,458,458,119438,119438,0,858,858,0,2.2,2.2,0.0,3,3,,analises_projeto_lote/adamlui_chatgpt-widescreen_35f38dc_1756687689/before,analises_projeto_lote/adamlui_chatgpt-widescreen_35f38dc_1756687689/after
adamlui/chatgpt-widescreen,5e5928737c3348704c66a67da1e566d34b5c5a53,56193043f3ff3e89d443100e4cb55236350fc826,kudo-sync-bot,458,458,119436,119438,2,858,858,0,2.2,2.2,0.0,6,4,,analises_projeto_lote/adamlui_chatgpt-widescreen_5e59287_1756687747/before,analises_projeto_lote/adamlui_chatgpt-widescreen_5e59287_1756687747/after
ban5104/fantasy-draft,ff990e065e83bb659f94bc8c9ec775df575f1f91,f94c9195a740abf4b27652e5f796bc5d388733d2,ban5104,29,30,33835,34219,384,634,654,20,11.123,10.9,-0.223,406264,405973,20313.2,analises_projeto_lote/ban5104_fantasy-draft_ff990e0_1756687804/before,analises_projeto_lote/ban5104_fantasy-draft_ff990e0_1756687804/after
ZNT1988/AlexIQ,3dd321fcdd27e748e2185d23bf9784c893601527,8343517cc9b814c41b1898d07a0d2ae4a548f5c7,AlexAI Developer,555,557,171321,171731,410,6746,6749,3,1.857,1.858,0.001,600,257,200.0,analises_projeto_lote/ZNT1988_AlexIQ_3dd321f_1756687814/before,analises_projeto_lote/ZNT1988_AlexIQ_3dd321f_1756687814/after
brolyroly007/academico3,b18aeab7a18584d0614b07d49745749c19202e75,ef5f78b3154e527bb24a7dbefec944d5b19eaebf,brolyroly007,98,98,21949,21954,5,975,971,-4,2.206,2.192,-0.014,118,108,29.5,analises_projeto_lote/brolyroly007_academico3_b18aeab_1756687837/before,analises_projeto_lote/brolyroly007_academico3_b18aeab_1756687837/after
ishan-sp/avisochatappl,269acbe08ba68cafeb049f3c411e491eac67cc4e,f0af633141812c9e210c7dd793b5d90728c163d9,ishan-sp,15,15,5691,5741,50,57,57,0,1.676,1.676,0.0,87,26,,analises_projeto_lote/ishan-sp_avisochatappl_269acbe_1756687846/before,analises_projeto_lote/ishan-sp_avisochatappl_269acbe_1756687846/after
ZNT1988/AlexIQ,4f5ad01d77e7e95e4d6588c1575a66d4d5c2179b,41042e1525499b78290a5e7148eaa9c8edb89606,AlexAI Developer,552,554,173829,174047,218,6733,6746,13,1.859,1.858,-0.001,277,7,21.308,analises_projeto_lote/ZNT1988_AlexIQ_4f5ad01_1756687852/before,analises_projeto_lote/ZNT1988_AlexIQ_4f5ad01_1756687852/after
okeidar/REAnalysis,ca4368cc3b5584427dd885557ff2c60214f1bdd5,36dcdb4292877b061148be98e73f7e153ab8c9be,okeidar,41,41,11190,10032,-1158,1244,879,-365,3.465,3.185,-0.28,169,1626,0.463,analises_projeto_lote/okeidar_REAnalysis_ca4368c_1756687876/before,analises_projeto_lote/okeidar_REAnalysis_ca4368c_1756687876/after
ZachBoyd1912/contentideapro,6732e2140c9acb7375ef2d3a93b1ab097c140e78,7f72a094307dae0151eddf05b10f0a2964edcdc9,zboyd712,181,182,96351,96451,100,1668,1670,2,1.685,1.683,-0.002,119,0,59.5,analises_projeto_lote/ZachBoyd1912_contentideapro_6732e21_1756687884/before,analises_projeto_lote/ZachBoyd1912_contentideapro_6732e21_1756687884/after
Rahul-htx/crypto-technicals,d0694b594d23cbb3e19826e83896ebae33f5f17f,cd1d31f3557735ba5ae807d6d2859cd9925be746,Rahul-htx,116,117,17186,17478,292,4765,4787,22,8.632,8.579,-0.053,660,9,30.0,analises_projeto_lote/Rahul-htx_crypto-technicals_d0694b5_1756687986/before,analises_projeto_lote/Rahul-htx_crypto-technicals_d0694b5_1756687986/after
miem-refugees/travel-agent,93f179a3de4dd9426ba1c3374deab0daa8738106,ad164d24d8ede7bfece0d3161a2776bab85fcb11,dependabot[bot],89,89,44418,44418,0,334,334,0,3.121,3.121,0.0,9,9,,analises_projeto_lote/miem-refugees_travel-agent_93f179a_1756687994/before,analises_projeto_lote/miem-refugees_travel-agent_93f179a_1756687994/after
Rahul-htx/crypto-technicals,0f5ff79fe47913d8b10cd1405ef4e4da014ff8d6,cb81395c3397d52b17bd807d49c8fdc7cc8ecaaf,Rahul-htx,98,101,15078,15585,507,4681,4712,31,9.072,8.958,-0.114,908,23,29.29,analises_projeto_lote/Rahul-htx_crypto-technicals_0f5ff79_1756688007/before,analises_projeto_lote/Rahul-htx_crypto-technicals_0f5ff79_1756688007/after
